LYC.ES_B AAAAAAAAAA
ARA.TH_C AAAAAAAAAB
LYC.ES_H AAAAAAAAAC
ARA.TH_E AAAAAAAAAD
TRI.AE_A AAAAAAAAAE
