CAN.SPE. AAAAAAAAAA
HOM.SA_B AAAAAAAAAB
HOM.SA_A AAAAAAAAAC
RAT.NOR. AAAAAAAAAD
XEN.LAE. AAAAAAAAAE
