LYC.ES_J AAAAAAAAAA
LYC.ES_G AAAAAAAAAB
LYC.ES_N AAAAAAAAAC
LYC.ES_E AAAAAAAAAD
LYC.ES_M AAAAAAAAAE
