ZEA.MA_H AAAAAAAAAA
LYC.ES_O AAAAAAAAAB
LYC.ES_N AAAAAAAAAC
CIN.HYB. AAAAAAAAAE
LYC.ES_F AAAAAAAAAD
