CAN.SPE. AAAAAAAAAA
CAE.EL_C AAAAAAAAAB
CAE.EL_B AAAAAAAAAC
CAE.EL_A AAAAAAAAAD
FUG.RUB. AAAAAAAAAE
