HUM.LU_C AAAAAAAAAE
LYC.ES_G AAAAAAAAAB
ORY.SA_B AAAAAAAAAA
TRI.AE_B AAAAAAAAAD
TRI.AE_A AAAAAAAAAC
