HUM.LU_D AAAAAAAAAA
HUM.JA_B AAAAAAAAAB
HUM.LU_A AAAAAAAAAC
HUM.LU_B AAAAAAAAAD
HUM.LU_C AAAAAAAAAE
