LYC.ES_C AAAAAAAAAA
LYC.ES_A AAAAAAAAAB
LYC.ES_I AAAAAAAAAC
LYC.ES_M AAAAAAAAAD
LYC.ES_N AAAAAAAAAE
