HOM.SA_A AAAAAAAAAA
FUG.RUB. AAAAAAAAAE
LYC.ES_G AAAAAAAAAC
ORI.CUN. AAAAAAAAAD
LYC.ES_L AAAAAAAAAB
