CAN.SPE. AAAAAAAAAA
HOM.SA_B AAAAAAAAAB
HOM.SA_A AAAAAAAAAC
GAL.GAL. AAAAAAAAAD
ORI.CUN. AAAAAAAAAE
