LYC.ES_I AAAAAAAAAA
LYC.ES_G AAAAAAAAAB
CAE.EL_B AAAAAAAAAC
ARA.TH_C AAAAAAAAAD
TRI.AE_C AAAAAAAAAE
