LYC.ES_G AAAAAAAAAD
LYC.ES_J AAAAAAAAAB
LYC.ES_H AAAAAAAAAC
RAT.RAT. AAAAAAAAAA
ORI.CUN. AAAAAAAAAE
