LYC.ES_B AAAAAAAAAA
LYC.ES_A AAAAAAAAAB
LYC.ES_H AAAAAAAAAC
LYC.ES_G AAAAAAAAAD
LYC.ES_E AAAAAAAAAE
