CAN.SPE. AAAAAAAAAA
RAT.RAT. AAAAAAAAAC
RAT.NOR. AAAAAAAAAB
ORI.CUN. AAAAAAAAAD
FUG.RUB. AAAAAAAAAE
