LYC.ES_C AAAAAAAAAA
ORY.SA_A AAAAAAAAAE
LYC.ES_I AAAAAAAAAC
TRI.AE_A AAAAAAAAAD
HUM.LU_B AAAAAAAAAB
