LEP.COL. AAAAAAAAAE
SCH.POM. AAAAAAAAAA
ZEA.MA_B AAAAAAAAAB
LYC.ES_H AAAAAAAAAC
TET.ROS. AAAAAAAAAD
