LYC.ES_C AAAAAAAAAA
LYC.ES_B AAAAAAAAAB
LYC.ES_N AAAAAAAAAC
LYC.ES_E AAAAAAAAAD
LYC.ES_J AAAAAAAAAE
