ZEA.MA_A AAAAAAAAAA
LYC.ES_B AAAAAAAAAB
ARA.TH_C AAAAAAAAAC
ZEA.MA_D AAAAAAAAAD
LYC.ES_I AAAAAAAAAE
