DRO.MEL. AAAAAAAAAE
RAT.RAT. AAAAAAAAAC
GAL.GAL. AAAAAAAAAA
CAE.EL_B AAAAAAAAAD
FUG.RUB. AAAAAAAAAB
