ZEA.MA_B AAAAAAAAAA
ZEA.MA_E AAAAAAAAAB
ZEA.MA_D AAAAAAAAAC
ZEA.MA_G AAAAAAAAAD
ZEA.MA_F AAAAAAAAAE
