ZEA.MA_A AAAAAAAAAA
ZEA.MA_B AAAAAAAAAB
ARA.TH_E AAAAAAAAAC
LYC.ES_H AAAAAAAAAD
TRI.AE_B AAAAAAAAAE
