HUM.LU_D AAAAAAAAAA
LYC.ES_O AAAAAAAAAB
ARA.TH_D AAAAAAAAAC
LYC.ES_M AAAAAAAAAD
ORY.SA_B AAAAAAAAAE
