LYC.ES_B AAAAAAAAAD
CIN.HYB. AAAAAAAAAA
ZEA.MA_H AAAAAAAAAE
ARA.TH_G AAAAAAAAAC
HUM.JA_A AAAAAAAAAB
