LYC.ES_G AAAAAAAAAD
LYC.ES_A AAAAAAAAAB
LYC.ES_H AAAAAAAAAC
ARA.TH_E AAAAAAAAAA
HUM.LU_B AAAAAAAAAE
