ORY.SA_A AAAAAAAAAD
LYC.ES_M AAAAAAAAAE
HUM.LU_B AAAAAAAAAC
ZEA.MA_G AAAAAAAAAB
HUM.LU_C AAAAAAAAAA
