CAE.BRI. AAAAAAAAAA
CAE.EL_D AAAAAAAAAB
CAE.EL_C AAAAAAAAAC
CAE.EL_B AAAAAAAAAD
CAE.EL_A AAAAAAAAAE
