CAE.BRI. AAAAAAAAAA
HOM.SA_B AAAAAAAAAB
FUG.RUB. AAAAAAAAAE
CAE.EL_C AAAAAAAAAC
XEN.LAE. AAAAAAAAAD
