ARA.TH_C AAAAAAAAAA
LYC.ES_O AAAAAAAAAB
ARA.TH_D AAAAAAAAAC
ORY.SA_A AAAAAAAAAD
HUM.LU_C AAAAAAAAAE
