LYC.ES_J AAAAAAAAAA
ARA.TH_C AAAAAAAAAB
ZEA.MA_B AAAAAAAAAC
HUM.JA_B AAAAAAAAAD
LYC.ES_F AAAAAAAAAE
