LYC.ES_K AAAAAAAAAA
CIN.HYB. AAAAAAAAAB
ORY.SA_A AAAAAAAAAE
TRI.AE_A AAAAAAAAAD
ZEA.MA_G AAAAAAAAAC
