LYC.ES_K AAAAAAAAAA
LYC.ES_A AAAAAAAAAB
LYC.ES_O AAAAAAAAAC
LYC.ES_N AAAAAAAAAD
LYC.ES_E AAAAAAAAAE
