ARA.TH_D AAAAAAAAAE
ZEA.MA_C AAAAAAAAAA
ZEA.MA_D AAAAAAAAAC
ZEA.MA_G AAAAAAAAAD
ZEA.MA_F AAAAAAAAAB
