CAE.BRI. AAAAAAAAAA
XEN.LAE. AAAAAAAAAB
RAT.NOR. AAAAAAAAAC
CAE.EL_A AAAAAAAAAD
FUG.RUB. AAAAAAAAAE
