LYC.ES_I AAAAAAAAAA
ZEA.MA_B AAAAAAAAAB
ZEA.MA_C AAAAAAAAAC
ORY.SA_A AAAAAAAAAE
ARA.TH_D AAAAAAAAAD
