LYC.ES_J AAAAAAAAAA
LYC.ES_I AAAAAAAAAB
LYC.ES_G AAAAAAAAAD
LYC.ES_O AAAAAAAAAC
LYC.ES_M AAAAAAAAAE
