GAL.GAL. AAAAAAAAAB
RAT.RAT. AAAAAAAAAC
RAT.NOR. AAAAAAAAAA
ORI.CUN. AAAAAAAAAD
XEN.LAE. AAAAAAAAAE
