ZEA.MA_H AAAAAAAAAA
ARA.TH_G AAAAAAAAAE
ARA.TH_E AAAAAAAAAC
ARA.TH_D AAAAAAAAAD
TRI.AE_B AAAAAAAAAB
