LYC.ES_C AAAAAAAAAA
ZEA.MA_B AAAAAAAAAB
ZEA.MA_E AAAAAAAAAC
ZEA.MA_D AAAAAAAAAD
HUM.LU_C AAAAAAAAAE
