LYC.ES_K AAAAAAAAAA
ZEA.MA_H AAAAAAAAAB
LYC.ES_G AAAAAAAAAC
LYC.ES_M AAAAAAAAAE
ORY.SA_A AAAAAAAAAD
