LYC.ES_C AAAAAAAAAA
ARA.TH_F AAAAAAAAAE
TRI.AE_A AAAAAAAAAC
TRI.AE_B AAAAAAAAAB
LYC.ES_E AAAAAAAAAD
