ZEA.MA_C AAAAAAAAAA
ARA.TH_F AAAAAAAAAE
HUM.JA_B AAAAAAAAAC
LYC.ES_I AAAAAAAAAB
TRI.AE_A AAAAAAAAAD
