HOM.SA_B AAAAAAAAAB
HOM.SA_A AAAAAAAAAC
RAT.RAT. AAAAAAAAAD
RAT.NOR. AAAAAAAAAA
FUG.RUB. AAAAAAAAAE
