YAR.LI_B AAAAAAAAAB
CAE.EL_D AAAAAAAAAC
LYC.ES_O AAAAAAAAAA
ZEA.MA_D AAAAAAAAAE
GAL.GAL. AAAAAAAAAD
