ARA.TH_A AAAAAAAAAA
ZEA.MA_H AAAAAAAAAB
LYC.ES_A AAAAAAAAAC
ZEA.MA_E AAAAAAAAAD
ARA.TH_D AAAAAAAAAE
