LYC.ES_G AAAAAAAAAD
LYC.ES_I AAAAAAAAAB
LYC.ES_H AAAAAAAAAC
LYC.ES_O AAAAAAAAAA
LYC.ES_M AAAAAAAAAE
