RAT.RAT. AAAAAAAAAD
HOM.SA_A AAAAAAAAAB
CAE.EL_D AAAAAAAAAC
GAL.GAL. AAAAAAAAAA
CAE.EL_B AAAAAAAAAE
