LYC.ES_K AAAAAAAAAA
LYC.ES_B AAAAAAAAAB
LYC.ES_G AAAAAAAAAE
LYC.ES_H AAAAAAAAAD
LYC.ES_O AAAAAAAAAC
