CAN.SPE. AAAAAAAAAA
RAT.RAT. AAAAAAAAAD
HOM.SA_B AAAAAAAAAE
GAL.GAL. AAAAAAAAAB
FUG.RUB. AAAAAAAAAC
