ZEA.MA_A AAAAAAAAAA
LYC.ES_K AAAAAAAAAB
HUM.JA_A AAAAAAAAAE
TRI.AE_B AAAAAAAAAD
HUM.LU_C AAAAAAAAAC
