LYC.ES_A AAAAAAAAAA
ZEA.MA_G AAAAAAAAAD
TRI.AE_A AAAAAAAAAC
LYC.ES_M AAAAAAAAAB
ARA.TH_F AAAAAAAAAE
