HUM.LU_D AAAAAAAAAA
LYC.ES_I AAAAAAAAAB
LYC.ES_G AAAAAAAAAC
ZEA.MA_D AAAAAAAAAD
HUM.LU_A AAAAAAAAAE
