RAT.NOR. AAAAAAAAAD
ZEA.MA_B AAAAAAAAAB
LYC.ES_G AAAAAAAAAA
LYC.ES_H AAAAAAAAAC
ARA.TH_G AAAAAAAAAE
