ZEA.MA_H AAAAAAAAAA
ZEA.MA_B AAAAAAAAAB
LYC.ES_G AAAAAAAAAC
HUM.LU_B AAAAAAAAAE
LYC.ES_M AAAAAAAAAD
