GAL.GAL. AAAAAAAAAC
HOM.SA_A AAAAAAAAAB
RAT.NOR. AAAAAAAAAA
ORI.CUN. AAAAAAAAAD
XEN.LAE. AAAAAAAAAE
