ARA.TH_A AAAAAAAAAA
LYC.ES_B AAAAAAAAAB
LYC.ES_A AAAAAAAAAC
SCH.POM. AAAAAAAAAD
TET.THE. AAAAAAAAAE
