ZEA.MA_A AAAAAAAAAA
LYC.ES_C AAAAAAAAAB
ZEA.MA_C AAAAAAAAAC
ZEA.MA_F AAAAAAAAAE
HUM.LU_C AAAAAAAAAD
