ZEA.MA_C AAAAAAAAAA
ORY.SA_B AAAAAAAAAE
ARA.TH_E AAAAAAAAAC
ZEA.MA_D AAAAAAAAAD
ARA.TH_F AAAAAAAAAB
