ZEA.MA_H AAAAAAAAAA
LYC.ES_A AAAAAAAAAB
ZEA.MA_E AAAAAAAAAC
LYC.ES_E AAAAAAAAAD
HUM.LU_C AAAAAAAAAE
