HUM.LU_D AAAAAAAAAA
ZEA.MA_H AAAAAAAAAB
LYC.ES_K AAAAAAAAAC
LYC.ES_O AAAAAAAAAD
LYC.ES_M AAAAAAAAAE
