LYC.ES_K AAAAAAAAAA
ZEA.MA_H AAAAAAAAAB
LYC.ES_H AAAAAAAAAC
ORY.SA_A AAAAAAAAAD
ARA.TH_F AAAAAAAAAE
