LYC.ES_H AAAAAAAAAD
ARA.TH_F AAAAAAAAAC
ZEA.MA_F AAAAAAAAAE
TRI.AE_A AAAAAAAAAA
LYC.ES_N AAAAAAAAAB
