902678 AAAAAAAAAA
243401 AAAAAAAAAB
415707 AAAAAAAAAC
27884 AAAAAAAAAD
911291 AAAAAAAAAE
888237 AAAAAAAABD
545785 AAAAAAAAAG
283307 AAAAAAAAAH
516479 AAAAAAAAAI
33137 AAAAAAAAAJ
487531 AAAAAAAAAK
775725 AAAAAAAAAL
679888 AAAAAAAAAM
763834 AAAAAAAAAN
404302 AAAAAAAAAO
257462 AAAAAAAAAP
507643 AAAAAAAACX
676 AAAAAAAAAR
530611 AAAAAAAAAS
49980 AAAAAAAAAT
286154 AAAAAAAAAU
945703 AAAAAAAAAV
476369 AAAAAAAAAW
759011 AAAAAAAAAX
437978 AAAAAAAAAY
731012 AAAAAAAAAZ
101542 AAAAAAAABN
41886 AAAAAAAABB
450325 AAAAAAAABC
596361 AAAAAAAAAF
211974 AAAAAAAABE
9091 AAAAAAAABF
64042 AAAAAAAABG
144213 AAAAAAAABH
567071 AAAAAAAABI
879669 AAAAAAAACY
818552 AAAAAAAABK
867420 AAAAAAAABL
978760 AAAAAAAABM
384837 AAAAAAAABA
635835 AAAAAAAABO
420925 AAAAAAAABP
588143 AAAAAAAABQ
524019 AAAAAAAABR
335771 AAAAAAAABS
665009 AAAAAAAABT
679872 AAAAAAAABU
70462 AAAAAAAABV
264238 AAAAAAAABW
998826 AAAAAAAABX
924893 AAAAAAAABY
810099 AAAAAAAABZ
758142 AAAAAAAACA
986030 AAAAAAAACB
984938 AAAAAAAACC
414786 AAAAAAAACD
983615 AAAAAAAACE
352505 AAAAAAAACF
313139 AAAAAAAACG
913331 AAAAAAAACH
297455 AAAAAAAACI
784149 AAAAAAAACJ
873399 AAAAAAAACK
586920 AAAAAAAACL
990594 AAAAAAAACM
486079 AAAAAAAACN
649760 AAAAAAAACO
586630 AAAAAAAACP
73821 AAAAAAAACQ
37250 AAAAAAAACR
829362 AAAAAAAADQ
669719 AAAAAAAACT
316990 AAAAAAAACU
206699 AAAAAAAACV
263464 AAAAAAAACW
760466 AAAAAAAAAQ
391521 AAAAAAAABJ
101913 AAAAAAAACZ
550218 AAAAAAAADA
171983 AAAAAAAADB
983932 AAAAAAAADC
72111 AAAAAAAADD
629917 AAAAAAAADE
634147 AAAAAAAADF
155203 AAAAAAAADG
356107 AAAAAAAADH
951197 AAAAAAAADI
132235 AAAAAAAADJ
175884 AAAAAAAADK
958228 AAAAAAAADL
455896 AAAAAAAADM
569582 AAAAAAAADN
817509 AAAAAAAADO
160063 AAAAAAAADP
450465 AAAAAAAACS
92020 AAAAAAAADR
868162 AAAAAAAADS
579434 AAAAAAAADT
929153 AAAAAAAADU
535118 AAAAAAAADV
