742769 AAAAAAAAAA
424744 AAAAAAAAAB
220419 AAAAAAAAAC
204581 AAAAAAAAAD
4027 AAAAAAAAAE
282306 AAAAAAAAAF
588325 AAAAAAAAAG
151946 AAAAAAAAAH
623537 AAAAAAAAAI
853976 AAAAAAAAAJ
324829 AAAAAAAACE
956252 AAAAAAAAAL
92305 AAAAAAAAAM
547680 AAAAAAAAAN
469374 AAAAAAAAAO
433945 AAAAAAAAAP
267076 AAAAAAAAAQ
273622 AAAAAAAAAR
225406 AAAAAAAAAS
476247 AAAAAAAAAT
855740 AAAAAAAAAU
118960 AAAAAAAAAV
903713 AAAAAAAAAW
723026 AAAAAAAAAX
363180 AAAAAAAAAY
876892 AAAAAAAAAZ
767164 AAAAAAAABA
132301 AAAAAAAABB
145602 AAAAAAAADL
501069 AAAAAAAABD
903051 AAAAAAAABE
879837 AAAAAAAABF
835974 AAAAAAAABG
165025 AAAAAAAABH
857452 AAAAAAAABI
635355 AAAAAAAABJ
251479 AAAAAAAABK
756752 AAAAAAAABL
365377 AAAAAAAABM
877495 AAAAAAAABN
47559 AAAAAAAABO
548504 AAAAAAAABP
273922 AAAAAAAABQ
958542 AAAAAAAABR
326104 AAAAAAAABS
854575 AAAAAAAABT
190344 AAAAAAAABU
669140 AAAAAAAABV
17890 AAAAAAAABW
194032 AAAAAAAABX
683961 AAAAAAAABY
950392 AAAAAAAABZ
344842 AAAAAAAACA
485197 AAAAAAAACB
710208 AAAAAAAACC
938191 AAAAAAAACD
263751 AAAAAAAAAK
442292 AAAAAAAACF
261683 AAAAAAAACG
474590 AAAAAAAACH
276530 AAAAAAAACI
497201 AAAAAAAACJ
969309 AAAAAAAACK
931811 AAAAAAAACL
411054 AAAAAAAACM
368067 AAAAAAAACN
233532 AAAAAAAACO
681766 AAAAAAAACP
603861 AAAAAAAACQ
669001 AAAAAAAACR
54098 AAAAAAAACS
78927 AAAAAAAACT
568490 AAAAAAAACU
565724 AAAAAAAACV
470711 AAAAAAAACW
845455 AAAAAAAACX
862097 AAAAAAAACY
228560 AAAAAAAACZ
575976 AAAAAAAADA
125482 AAAAAAAADB
36934 AAAAAAAADC
788392 AAAAAAAADD
664935 AAAAAAAADE
244214 AAAAAAAADF
170782 AAAAAAAADG
739823 AAAAAAAADH
708015 AAAAAAAADI
860216 AAAAAAAADJ
462988 AAAAAAAADK
441887 AAAAAAAABC
683655 AAAAAAAADM
252940 AAAAAAAADN
134458 AAAAAAAADO
785338 AAAAAAAADP
415481 AAAAAAAADQ
854601 AAAAAAAADR
798038 AAAAAAAADS
306557 AAAAAAAADT
67056 AAAAAAAADU
9691 AAAAAAAADV
