507457 AAAAAAAAAA
418604 AAAAAAAAAB
803425 AAAAAAAAAC
211954 AAAAAAAAAD
275205 AAAAAAAAAE
314580 AAAAAAAAAF
893482 AAAAAAAAAG
200469 AAAAAAAAAH
740535 AAAAAAAAAI
516450 AAAAAAAAAJ
62786 AAAAAAAAAK
838753 AAAAAAAAAL
530181 AAAAAAAAAM
330192 AAAAAAAAAN
890981 AAAAAAAAAO
442454 AAAAAAAAAP
382505 AAAAAAAAAQ
794936 AAAAAAAAAR
736603 AAAAAAAAAS
727489 AAAAAAAAAT
155124 AAAAAAAAAU
785532 AAAAAAAAAV
909938 AAAAAAAAAW
321608 AAAAAAAAAX
509238 AAAAAAAAAY
