216196 AAAAAAAAAA
186284 AAAAAAAAAB
671556 AAAAAAAAAC
266429 AAAAAAAAAD
781104 AAAAAAAAAE
261517 AAAAAAAAAF
77697 AAAAAAAAAG
805112 AAAAAAAAAH
340013 AAAAAAAAAI
744110 AAAAAAAAAJ
572478 AAAAAAAAAK
956002 AAAAAAAAAL
50824 AAAAAAAAAM
632823 AAAAAAAAAN
81233 AAAAAAAAAO
920722 AAAAAAAAAP
986439 AAAAAAAAAQ
226 AAAAAAAAAR
507604 AAAAAAAAAS
51172 AAAAAAAAAT
791800 AAAAAAAAAU
641122 AAAAAAAAAV
618814 AAAAAAAAAW
398562 AAAAAAAAAX
537990 AAAAAAAAAY
