678985 AAAAAAAAAA
196582 AAAAAAAAAB
524636 AAAAAAAAAC
104831 AAAAAAAAAD
515646 AAAAAAAAAE
149754 AAAAAAAAAF
717759 AAAAAAAAAG
794510 AAAAAAAAAH
107353 AAAAAAAAAI
187419 AAAAAAAAAJ
792690 AAAAAAAAAK
508090 AAAAAAAAAL
614813 AAAAAAAAAM
654115 AAAAAAAAAN
199551 AAAAAAAAAO
78848 AAAAAAAAAP
545797 AAAAAAAAAQ
503912 AAAAAAAAAR
173562 AAAAAAAAAS
739290 AAAAAAAAAT
364903 AAAAAAAAAV
176656 AAAAAAAAAU
75388 AAAAAAAAAW
55650 AAAAAAAAAX
145848 AAAAAAAAAY
