215099 AAAAAAAAAA
397306 AAAAAAAAAB
441683 AAAAAAAAAC
822694 AAAAAAAAAD
331055 AAAAAAAAAE
563398 AAAAAAAAAF
216960 AAAAAAAAAG
610370 AAAAAAAAAH
458633 AAAAAAAAAI
548912 AAAAAAAAAJ
513901 AAAAAAAAAK
709187 AAAAAAAAAL
152088 AAAAAAAAAM
232957 AAAAAAAAAN
632081 AAAAAAAAAO
215227 AAAAAAAAAP
474051 AAAAAAAAAQ
133826 AAAAAAAAAR
230172 AAAAAAAAAS
825976 AAAAAAAAAT
755784 AAAAAAAAAU
884910 AAAAAAAADS
56191 AAAAAAAAAV
555869 AAAAAAAAAW
197 AAAAAAAAAX
580849 AAAAAAAAAY
240135 AAAAAAAAAZ
12586 AAAAAAAABA
127301 AAAAAAAABB
694871 AAAAAAAABC
385835 AAAAAAAABD
478295 AAAAAAAABE
126014 AAAAAAAABF
714288 AAAAAAAABG
633681 AAAAAAAABH
710432 AAAAAAAABI
724511 AAAAAAAABJ
756292 AAAAAAAABK
803576 AAAAAAAABL
479078 AAAAAAAABM
387746 AAAAAAAABN
718261 AAAAAAAABO
701139 AAAAAAAABP
775829 AAAAAAAABQ
352668 AAAAAAAABR
381467 AAAAAAAABS
372091 AAAAAAAABT
966459 AAAAAAAABU
969667 AAAAAAAABV
51217 AAAAAAAABW
694140 AAAAAAAABX
356281 AAAAAAAABY
639130 AAAAAAAABZ
893581 AAAAAAAACA
401885 AAAAAAAACB
692541 AAAAAAAACC
974705 AAAAAAAACD
677795 AAAAAAAACE
654255 AAAAAAAACF
771313 AAAAAAAACG
513111 AAAAAAAACH
110678 AAAAAAAACI
39903 AAAAAAAACJ
593108 AAAAAAAACK
602961 AAAAAAAACL
789462 AAAAAAAACM
416815 AAAAAAAADQ
891849 AAAAAAAACO
524284 AAAAAAAACP
300826 AAAAAAAACQ
959436 AAAAAAAACR
605918 AAAAAAAACS
568415 AAAAAAAACT
543254 AAAAAAAACV
990282 AAAAAAAACW
133238 AAAAAAAACX
488753 AAAAAAAACY
822282 AAAAAAAACZ
502115 AAAAAAAADA
813075 AAAAAAAADB
782132 AAAAAAAADC
143446 AAAAAAAADD
683546 AAAAAAAADE
1752 AAAAAAAADF
819266 AAAAAAAADG
539339 AAAAAAAADH
594203 AAAAAAAADI
133037 AAAAAAAADJ
977041 AAAAAAAADK
870570 AAAAAAAADL
779179 AAAAAAAADM
931703 AAAAAAAADN
567682 AAAAAAAADO
3783 AAAAAAAADP
565393 AAAAAAAACN
382233 AAAAAAAADR
159204 AAAAAAAACU
762544 AAAAAAAADT
302594 AAAAAAAADU
314361 AAAAAAAADV
