629944 AAAAAAAAAA
202201 AAAAAAAAAB
356643 AAAAAAAAAC
222622 AAAAAAAAAD
842666 AAAAAAAAAE
679730 AAAAAAAAAF
31925 AAAAAAAAAG
894357 AAAAAAAAAH
729094 AAAAAAAAAI
944065 AAAAAAAAAJ
228639 AAAAAAAAAK
718988 AAAAAAAAAL
229624 AAAAAAAADG
801184 AAAAAAAAAN
798026 AAAAAAAADJ
617587 AAAAAAAAAP
482221 AAAAAAAAAQ
567063 AAAAAAAAAR
11106 AAAAAAAAAS
572849 AAAAAAAAAT
673423 AAAAAAAAAU
124861 AAAAAAAABM
954111 AAAAAAAAAW
562287 AAAAAAAAAX
306455 AAAAAAAABQ
907589 AAAAAAAACM
125758 AAAAAAAAAY
238453 AAAAAAAAAZ
365210 AAAAAAAABA
815741 AAAAAAAABB
52717 AAAAAAAABC
14053 AAAAAAAABD
170752 AAAAAAAABE
547419 AAAAAAAABF
60624 AAAAAAAABG
343415 AAAAAAAABH
772813 AAAAAAAABI
812976 AAAAAAAABJ
274789 AAAAAAAABK
36909 AAAAAAAABL
839165 AAAAAAAAAV
266908 AAAAAAAABN
994313 AAAAAAAABO
761160 AAAAAAAABP
694709 AAAAAAAADB
572155 AAAAAAAABR
571442 AAAAAAAABS
874660 AAAAAAAABT
997253 AAAAAAAABU
529884 AAAAAAAABV
859915 AAAAAAAABW
628643 AAAAAAAABX
858194 AAAAAAAABY
210018 AAAAAAAABZ
170243 AAAAAAAACA
408990 AAAAAAAACB
272134 AAAAAAAACC
759626 AAAAAAAACD
549821 AAAAAAAACE
391939 AAAAAAAACF
772523 AAAAAAAACG
913443 AAAAAAAACH
820065 AAAAAAAACI
320216 AAAAAAAACJ
179188 AAAAAAAACK
768698 AAAAAAAACL
846879 AAAAAAAACZ
191626 AAAAAAAACN
904716 AAAAAAAACO
501415 AAAAAAAACP
720585 AAAAAAAACQ
58990 AAAAAAAACR
236737 AAAAAAAACS
439740 AAAAAAAACT
57175 AAAAAAAACU
362306 AAAAAAAACV
235854 AAAAAAAACW
347796 AAAAAAAADA
56471 AAAAAAAACY
173120 AAAAAAAACX
431265 AAAAAAAADC
13063 AAAAAAAADD
679616 AAAAAAAADE
337858 AAAAAAAADF
952111 AAAAAAAAAM
942281 AAAAAAAADH
930678 AAAAAAAADI
125899 AAAAAAAAAO
642573 AAAAAAAADK
236904 AAAAAAAADL
967475 AAAAAAAADM
416997 AAAAAAAADN
610095 AAAAAAAADO
892480 AAAAAAAADP
638984 AAAAAAAADQ
728948 AAAAAAAADR
228074 AAAAAAAADS
570243 AAAAAAAADT
958011 AAAAAAAADU
723048 AAAAAAAADV
