406611 AAAAAAAAAA
415853 AAAAAAAAAB
425115 AAAAAAAAAC
122821 AAAAAAAAAD
327143 AAAAAAAAAE
241189 AAAAAAAAAF
359131 AAAAAAAAAG
856995 AAAAAAAAAH
39501 AAAAAAAAAI
470998 AAAAAAAAAJ
320548 AAAAAAAAAK
562829 AAAAAAAAAL
511867 AAAAAAAAAM
746879 AAAAAAAABT
119963 AAAAAAAAAO
672385 AAAAAAAAAP
569750 AAAAAAAAAQ
330131 AAAAAAAAAR
767676 AAAAAAAAAS
946065 AAAAAAAAAT
945893 AAAAAAAAAU
448793 AAAAAAAAAV
772023 AAAAAAAABK
657555 AAAAAAAAAW
442983 AAAAAAAAAY
402353 AAAAAAAAAX
822818 AAAAAAAAAZ
656160 AAAAAAAABA
183988 AAAAAAAABB
125851 AAAAAAAABC
654770 AAAAAAAABD
940445 AAAAAAAABE
417315 AAAAAAAABF
697531 AAAAAAAABG
889110 AAAAAAAABH
70789 AAAAAAAABI
864019 AAAAAAAABJ
850884 AAAAAAAABL
839433 AAAAAAAABM
845146 AAAAAAAABN
915073 AAAAAAAABO
830133 AAAAAAAABP
874440 AAAAAAAABQ
420655 AAAAAAAABR
659005 AAAAAAAABS
58676 AAAAAAAAAN
759426 AAAAAAAABU
345969 AAAAAAAABV
749895 AAAAAAAABW
537784 AAAAAAAABX
94395 AAAAAAAABY
642517 AAAAAAAABZ
156008 AAAAAAAACA
724572 AAAAAAAACB
154281 AAAAAAAACC
344667 AAAAAAAACD
947257 AAAAAAAACE
487116 AAAAAAAACF
773699 AAAAAAAACG
993170 AAAAAAAACH
116743 AAAAAAAACI
338106 AAAAAAAACJ
856521 AAAAAAAACK
151054 AAAAAAAACL
514536 AAAAAAAACM
665860 AAAAAAAACN
105286 AAAAAAAACO
518153 AAAAAAAACP
351687 AAAAAAAACQ
340429 AAAAAAAACR
55140 AAAAAAAACS
236635 AAAAAAAACT
776140 AAAAAAAACU
98787 AAAAAAAACV
372035 AAAAAAAACW
71521 AAAAAAAACX
655693 AAAAAAAACY
39450 AAAAAAAADQ
666450 AAAAAAAADA
993389 AAAAAAAADB
180878 AAAAAAAADC
154400 AAAAAAAADR
757785 AAAAAAAADE
629859 AAAAAAAADF
605046 AAAAAAAADG
945104 AAAAAAAADH
584183 AAAAAAAADI
767558 AAAAAAAADJ
19929 AAAAAAAADK
167884 AAAAAAAADL
770551 AAAAAAAADM
759108 AAAAAAAADN
184899 AAAAAAAADO
6541 AAAAAAAADP
128229 AAAAAAAACZ
576567 AAAAAAAADD
655747 AAAAAAAADS
968613 AAAAAAAADT
9512 AAAAAAAADU
107931 AAAAAAAADV
