643314 AAAAAAAAAA
707720 AAAAAAAAAB
284964 AAAAAAAAAC
802256 AAAAAAAAAD
677165 AAAAAAAAAE
239422 AAAAAAAAAN
167970 AAAAAAAAAG
676629 AAAAAAAAAH
127246 AAAAAAAAAI
227439 AAAAAAAAAJ
562642 AAAAAAAAAK
903421 AAAAAAAAAL
664969 AAAAAAAAAM
639105 AAAAAAAAAF
344952 AAAAAAAAAO
769674 AAAAAAAAAP
921140 AAAAAAAAAQ
701202 AAAAAAAAAR
491943 AAAAAAAAAS
773217 AAAAAAAAAT
96587 AAAAAAAAAU
59033 AAAAAAAAAV
266914 AAAAAAAAAW
744447 AAAAAAAAAX
376389 AAAAAAAAAY
