134129 AAAAAAAAAA
240658 AAAAAAAAAB
914029 AAAAAAAAAC
543430 AAAAAAAAAD
142195 AAAAAAAAAE
590734 AAAAAAAAAF
565159 AAAAAAAAAG
5600 AAAAAAAAAH
261326 AAAAAAAAAI
9285 AAAAAAAAAJ
751886 AAAAAAAAAK
899463 AAAAAAAAAL
83734 AAAAAAAAAM
128179 AAAAAAAAAN
648289 AAAAAAAAAO
793955 AAAAAAAAAP
275010 AAAAAAAAAQ
789814 AAAAAAAAAR
880223 AAAAAAAAAS
572402 AAAAAAAAAT
325713 AAAAAAAAAU
705622 AAAAAAAAAV
735602 AAAAAAAAAW
661669 AAAAAAAAAX
777610 AAAAAAAAAY
