20307 AAAAAAAAAW
627746 AAAAAAAAAB
815881 AAAAAAAAAC
416274 AAAAAAAAAD
445889 AAAAAAAAAE
14092 AAAAAAAAAF
476620 AAAAAAAAAG
920612 AAAAAAAAAH
822715 AAAAAAAAAI
926707 AAAAAAAAAJ
79582 AAAAAAAAAK
169813 AAAAAAAAAL
719448 AAAAAAAAAM
40928 AAAAAAAAAN
166492 AAAAAAAAAO
596825 AAAAAAAAAP
55989 AAAAAAAAAQ
787129 AAAAAAAAAR
639102 AAAAAAAAAS
376006 AAAAAAAAAT
410655 AAAAAAAAAU
799498 AAAAAAAAAV
688645 AAAAAAAAAA
498223 AAAAAAAAAX
616206 AAAAAAAAAY
