SHDE AAAAAAAAAA
SIHB AAAAAAAAAB
SIC AAAAAAAAAC
SIF AAAAAAAAAD
SBIE AAAAAAAAAE
SBIF AAAAAAAAAF
SBIB AAAAAAAAAG
SFAC AAAAAAAAAH
SIAC AAAAAAAAAI
SFAE AAAAAAAAAJ
SGGI AAAAAAAAAK
SHCJ AAAAAAAAAL
SJAD AAAAAAAAAM
SDFJ AAAAAAAAAN
SBFE AAAAAAAAAO
SFFA AAAAAAAAAP
SFH AAAAAAAABM
SCGE AAAAAAAAAR
SGAJ AAAAAAAADQ
SCEG AAAAAAAAAT
SIJI AAAAAAAAAU
SJBD AAAAAAAAAV
SBCA AAAAAAAAAW
SJBA AAAAAAAAAX
SBCD AAAAAAAAAY
SJBB AAAAAAAAAZ
SEAB AAAAAAAABA
SEAA AAAAAAAABB
SJBI AAAAAAAABC
SDCF AAAAAAAABD
SCD AAAAAAAABE
SCJC AAAAAAAABF
SCA AAAAAAAABG
SHAC AAAAAAAABH
SFCI AAAAAAAABI
SEIJ AAAAAAAABJ
SGEB AAAAAAAABK
SICC AAAAAAAABL
SFFC AAAAAAAAAQ
SIIG AAAAAAAABN
SIID AAAAAAAABO
SHE AAAAAAAABP
SHH AAAAAAAABQ
SDDG AAAAAAAABR
SCDD AAAAAAAABS
SFHF AAAAAAAABT
SFHE AAAAAAAABU
SG AAAAAAAABV
SIDE AAAAAAAABW
SHBE AAAAAAAABX
SIBG AAAAAAAABY
SEHF AAAAAAAABZ
SJJJ AAAAAAAACA
SGDE AAAAAAAACB
SBEH AAAAAAAACC
SJDA AAAAAAAACD
SCEF AAAAAAAACE
SJDF AAAAAAAACF
SECC AAAAAAAACG
SECE AAAAAAAACH
SDAC AAAAAAAACI
SGCI AAAAAAAACJ
SFEA AAAAAAAACK
SGCA AAAAAAAACL
SCHF AAAAAAAACM
SED AAAAAAAACN
SDIH AAAAAAAACO
SIEG AAAAAAAACP
SIEF AAAAAAAACQ
SEH AAAAAAAADE
SCBA AAAAAAAACS
SJI AAAAAAAACT
SJEE AAAAAAAACU
SBBG AAAAAAAACV
SJG AAAAAAAACW
SFJG AAAAAAAACX
SFJI AAAAAAAACY
SDJC AAAAAAAACZ
SDJF AAAAAAAADA
SBJC AAAAAAAADB
SBE AAAAAAAADC
SC AAAAAAAADD
SDIA AAAAAAAACR
SFBE AAAAAAAADF
SFBD AAAAAAAADG
SEJA AAAAAAAADH
SCAJ AAAAAAAADI
SCAD AAAAAAAADJ
SJFI AAAAAAAADK
SGIH AAAAAAAADL
SBGB AAAAAAAADM
SGAB AAAAAAAADN
SGA AAAAAAAADO
SCFE AAAAAAAADP
SCFC AAAAAAAAAS
SBDI AAAAAAAADR
SGHD AAAAAAAADS
SGHJ AAAAAAAADT
SCIC AAAAAAAADU
SDHB AAAAAAAADV
