SIFF AAAAAAAAAA
SCED AAAAAAAAAB
SDEB AAAAAAAAAC
SGIH AAAAAAAAAD
SJDJ AAAAAAAAAE
SJFC AAAAAAAAAF
SDAF AAAAAAAAAG
SBIA AAAAAAAAAH
SEG AAAAAAAAAI
SEIH AAAAAAAAAJ
SHEF AAAAAAAAAK
SCGI AAAAAAAAAU
SIGH AAAAAAAAAM
SJI AAAAAAAAAN
SIBH AAAAAAAAAW
SFJC AAAAAAAAAP
SBFG AAAAAAAAAR
SFJG AAAAAAAAAQ
SFJF AAAAAAAAAS
SJJH AAAAAAAAAT
SIBD AAAAAAAAAL
SJJJ AAAAAAAAAV
SGFJ AAAAAAAAAO
SBI AAAAAAAAAX
SFBE AAAAAAAAAY
