SHDA AAAAAAAAAA
SHDB AAAAAAAAAB
SHDD AAAAAAAAAC
SBAG AAAAAAAAAD
SBAC AAAAAAAAAE
SIJ AAAAAAAAAF
SBAJ AAAAAAAAAG
SBIC AAAAAAAAAH
SGGB AAAAAAAAAI
SIAE AAAAAAAAAJ
SCDI AAAAAAAAAK
SHCC AAAAAAAAAL
SFAH AAAAAAAAAM
SGGJ AAAAAAAAAN
SIAI AAAAAAAAAO
SJAD AAAAAAAAAP
SEFA AAAAAAAAAQ
SEFF AAAAAAAAAR
SEFE AAAAAAAAAS
SEFI AAAAAAAAAT
SGBI AAAAAAAAAU
SBFE AAAAAAAAAV
SGFA AAAAAAAAAW
SGFB AAAAAAAAAX
SJHI AAAAAAAAAY
SFFJ AAAAAAAAAZ
SCEG AAAAAAAABA
SHJE AAAAAAAABB
SIJD AAAAAAAABC
SIJE AAAAAAAABD
SEAI AAAAAAAABE
SFIA AAAAAAAABF
SDCD AAAAAAAABG
SCJA AAAAAAAABH
SCJF AAAAAAAABI
SCB AAAAAAAABJ
SGEA AAAAAAAABK
SFCG AAAAAAAABL
SICC AAAAAAAABM
SJCG AAAAAAAABO
SIIA AAAAAAAABP
SFHJ AAAAAAAABQ
SHG AAAAAAAABR
SBHG AAAAAAAABS
SEHG AAAAAAAABT
SGDG AAAAAAAABU
SIBH AAAAAAAABV
SIBI AAAAAAAABW
SHBI AAAAAAAABX
SHBH AAAAAAAABY
SHHF AAAAAAAABZ
SJDF AAAAAAAACA
SHHC AAAAAAAACB
SDAG AAAAAAAACC
SDAE AAAAAAAACD
SGCG AAAAAAAACE
SECH AAAAAAAACF
SEG AAAAAAAACG
SEC AAAAAAAACH
SDID AAAAAAAACI
SHIH AAAAAAAACJ
SCBH AAAAAAAACK
SCBI AAAAAAAACL
SJI AAAAAAAACM
SBBE AAAAAAAACN
SIEA AAAAAAAACO
SGJJ AAAAAAAACP
SEBC AAAAAAAACQ
SGBB AAAAAAAACR
SDJC AAAAAAAACS
SBJG AAAAAAAACT
SDJG AAAAAAAACU
SDJD AAAAAAAACV
SBI AAAAAAAACW
SFBG AAAAAAAACX
SIFD AAAAAAAACY
SIFE AAAAAAAACZ
SEEF AAAAAAAADA
SEEE AAAAAAAADB
SGIG AAAAAAAADC
SJFE AAAAAAAADD
SGIB AAAAAAAADE
SJID AAAAAAAADF
SGH AAAAAAAADG
SJIC AAAAAAAADH
SGC AAAAAAAADI
SGG AAAAAAAADJ
SJJC AAAAAAAADR
SEDA AAAAAAAADL
SGHD AAAAAAAADM
SEDC AAAAAAAADN
SBDA AAAAAAAADO
SJGB AAAAAAAABN
SBDG AAAAAAAADP
SCIC AAAAAAAADQ
SDA AAAAAAAADK
SCIH AAAAAAAADS
SGHG AAAAAAAADT
SDHB AAAAAAAADU
SDHF AAAAAAAADV
