SCAJ AAAAAAAAAA
SIHB AAAAAAAAAB
SDGG AAAAAAAAAC
SJC AAAAAAAAAD
SJFB AAAAAAAAAE
SCJC AAAAAAAAAF
SGGG AAAAAAAAAG
SGEA AAAAAAAAAH
SIBF AAAAAAAAAI
SGEC AAAAAAAAAJ
SGED AAAAAAAAAK
SJHH AAAAAAAAAY
SJAB AAAAAAAAAM
SEFG AAAAAAAAAN
SFHB AAAAAAAAAO
SBBC AAAAAAAAAP
SEBF AAAAAAAAAQ
SFDI AAAAAAAAAR
SFFA AAAAAAAAAS
SHBI AAAAAAAAAX
SBJ AAAAAAAAAU
SDHB AAAAAAAAAV
SFFI AAAAAAAAAW
SHFE AAAAAAAAAT
SGDA AAAAAAAAAL
