SHDD AAAAAAAAAA
SIHE AAAAAAAAAB
SHDJ AAAAAAAAAC
SIHA AAAAAAAAAD
SIHB AAAAAAAAAE
SFIA AAAAAAAAAF
SEGF AAAAAAAAAG
SEGC AAAAAAAAAH
SBIJ AAAAAAAAAI
SBIE AAAAAAAAAJ
SIAD AAAAAAAAAK
SGGE AAAAAAAAAL
SBAAA AAAAAAAAAM
SCDA AAAAAAAAAN
SHCH AAAAAAAAAO
SHEB AAAAAAAAAP
SHEC AAAAAAAAAQ
SIGG AAAAAAAAAR
SIGH AAAAAAAAAS
SICE AAAAAAAABP
SEFE AAAAAAAAAU
SDFH AAAAAAAAAV
SBFH AAAAAAAAAW
SJHF AAAAAAAAAX
SJHD AAAAAAAAAY
SFE AAAAAAAAAZ
SFC AAAAAAAABA
SIJD AAAAAAAABB
SDCH AAAAAAAABC
SEAH AAAAAAAABD
SJBC AAAAAAAABE
SDCD AAAAAAAABF
SJBH AAAAAAAABG
SCJI AAAAAAAABH
SCJJ AAAAAAAABI
SDEI AAAAAAAABJ
SCE AAAAAAAABK
SGEI AAAAAAAABL
SGEH AAAAAAAABM
SFCJ AAAAAAAABN
SFIF AAAAAAAABO
SFCF AAAAAAAAAT
SGEE AAAAAAAABQ
SFCC AAAAAAAABR
SJCA AAAAAAAABS
SJCE AAAAAAAABT
SC AAAAAAAABU
SDDE AAAAAAAABV
SHI AAAAAAAABW
SFHF AAAAAAAABX
SFHE AAAAAAAABY
SDDB AAAAAAAABZ
SEDD AAAAAAAADL
SIBB AAAAAAAACB
SHBF AAAAAAAACC
SCCF AAAAAAAACD
SCCD AAAAAAAACE
SBDC AAAAAAAADP
SJDA AAAAAAAACG
SJDG AAAAAAAACH
SHHI AAAAAAAACI
SDAD AAAAAAAACJ
SECB AAAAAAAACK
SGCJ AAAAAAAACL
SDAH AAAAAAAACM
SEF AAAAAAAACN
SCHC AAAAAAAACO
SDII AAAAAAAACP
SHGB AAAAAAAACQ
SHGD AAAAAAAACR
SHGF AAAAAAAACS
SCBE AAAAAAAACT
SCBF AAAAAAAACU
SCBG AAAAAAAACV
SHIA AAAAAAAACW
SDBJ AAAAAAAACX
SJF AAAAAAAACY
SJE AAAAAAAACZ
SGBG AAAAAAAADA
SBJE AAAAAAAADB
SI AAAAAAAADC
SBJC AAAAAAAADD
SEJF AAAAAAAADE
SG AAAAAAAADF
SCAD AAAAAAAADG
SCAG AAAAAAAADH
SEED AAAAAAAADI
SGIB AAAAAAAADJ
SFGI AAAAAAAADK
SGHB AAAAAAAACA
SEDE AAAAAAAADM
SEDF AAAAAAAADN
SEDG AAAAAAAADO
SGHJ AAAAAAAACF
SFDD AAAAAAAADQ
SFDA AAAAAAAADR
SDHJ AAAAAAAADS
SCID AAAAAAAADT
SHFF AAAAAAAADU
SDJ AAAAAAAADV
