SHDE AAAAAAAAAA
SIHJ AAAAAAAAAB
SID AAAAAAAAAC
SEGG AAAAAAAAAD
SDEI AAAAAAAAAE
SBIE AAAAAAAAAF
SDBF AAAAAAAAAG
SCDJ AAAAAAAAAH
SFAE AAAAAAAAAI
SHCC AAAAAAAAAJ
SFAH AAAAAAAAAK
SCDA AAAAAAAAAL
SIAJ AAAAAAAAAM
SIGE AAAAAAAAAN
SIGD AAAAAAAAAO
SHEJ AAAAAAAAAP
SEFD AAAAAAAAAQ
SEFJ AAAAAAAAAR
SEFH AAAAAAAAAS
SGFD AAAAAAAAAT
SJHA AAAAAAAAAU
SGFH AAAAAAAAAV
SGFJ AAAAAAAABQ
SCGC AAAAAAAAAX
SFFH AAAAAAAAAY
SFA AAAAAAAAAZ
SIJI AAAAAAAABA
SHJI AAAAAAAABB
SHJH AAAAAAAABC
SIJB AAAAAAAABD
SCEI AAAAAAAABE
SJBD AAAAAAAABF
SBCD AAAAAAAABG
SBCJ AAAAAAAABH
SDCC AAAAAAAABI
SEGF AAAAAAAABJ
SICJ AAAAAAAABK
SEIJ AAAAAAAABL
SEII AAAAAAAABM
SICB AAAAAAAABN
SJCB AAAAAAAABO
SHI AAAAAAAABP
SCGE AAAAAAAAAW
SBHE AAAAAAAABR
SBHA AAAAAAAABS
SEJC AAAAAAAABT
SEHB AAAAAAAABU
SGDJ AAAAAAAABV
SEHF AAAAAAAABW
SJJA AAAAAAAABX
SHBH AAAAAAAABY
SEDB AAAAAAAADL
SBEI AAAAAAAACA
SJDA AAAAAAAACB
SBEC AAAAAAAACC
SGCJ AAAAAAAACD
SGCF AAAAAAAACE
SGCD AAAAAAAACF
SCHD AAAAAAAACG
SED AAAAAAAACH
SDIF AAAAAAAACI
SDIG AAAAAAAACJ
SDID AAAAAAAACK
SHGC AAAAAAAACL
SIEG AAAAAAAACM
SIED AAAAAAAACN
SCBB AAAAAAAACO
SDBH AAAAAAAADQ
SJEB AAAAAAAACP
SJEC AAAAAAAACQ
SBBI AAAAAAAACR
SBBD AAAAAAAACS
SGJH AAAAAAAACT
SJG AAAAAAAACU
SGBJ AAAAAAAACV
SFJF AAAAAAAACW
SGBF AAAAAAAACX
SEBI AAAAAAAACY
SF AAAAAAAACZ
SEJA AAAAAAAADA
SCAH AAAAAAAADB
SIFC AAAAAAAADC
SDGD AAAAAAAADD
SJFC AAAAAAAADE
SBGF AAAAAAAADF
SFGC AAAAAAAADG
SFGA AAAAAAAADH
SJII AAAAAAAADJ
SBDJ AAAAAAAADK
SGHD AAAAAAAABZ
SEDC AAAAAAAADM
SJGE AAAAAAAADN
SJGA AAAAAAAADO
SCIA AAAAAAAADP
SDG AAAAAAAADI
SDA AAAAAAAADR
SDB AAAAAAAADS
SDHC AAAAAAAADT
SDH AAAAAAAADU
SDBB AAAAAAAADV
