SIHI AAAAAAAAAA
SIHJ AAAAAAAAAB
SIHA AAAAAAAAAC
SDEF AAAAAAAAAD
SBAB AAAAAAAAAE
SEGG AAAAAAAAAF
SEGF AAAAAAAAAG
SBAH AAAAAAAAAH
SEGB AAAAAAAAAI
SBIJ AAAAAAAAAJ
SFAD AAAAAAAAAK
SGGI AAAAAAAAAL
SHEF AAAAAAAAAM
SIGG AAAAAAAAAN
SIGF AAAAAAAAAO
SHEI AAAAAAAAAP
SDFD AAAAAAAAAQ
SDFH AAAAAAAAAR
SBFG AAAAAAAAAS
SHHD AAAAAAAAAT
SBFH AAAAAAAAAU
SEBA AAAAAAAACT
SJHC AAAAAAAAAW
SFF AAAAAAAAAX
SEGI AAAAAAAAAY
SCGB AAAAAAAABU
SIJI AAAAAAAABA
SHJD AAAAAAAABB
SDCJ AAAAAAAABC
SEAG AAAAAAAABD
SCJH AAAAAAAABE
SIH AAAAAAAABF
SCG AAAAAAAABG
SCJC AAAAAAAABH
SEID AAAAAAAABI
SFCF AAAAAAAABJ
SGEG AAAAAAAABK
SJCI AAAAAAAABL
SJCD AAAAAAAABM
SJCE AAAAAAAABN
SHE AAAAAAAABO
SHF AAAAAAAABP
SDDE AAAAAAAABQ
SFHE AAAAAAAABR
SBHJ AAAAAAAABS
SBHC AAAAAAAABT
SFFH AAAAAAAAAZ
SEHC AAAAAAAABV
SEHD AAAAAAAABW
SGDI AAAAAAAABX
SGDG AAAAAAAABY
SGDE AAAAAAAABZ
SCCC AAAAAAAACA
SBEI AAAAAAAACB
SGE AAAAAAAADN
SJDH AAAAAAAACC
SHHI AAAAAAAACD
SECI AAAAAAAACE
SDAJ AAAAAAAACF
SEE AAAAAAAACG
SDAH AAAAAAAACH
SCHG AAAAAAAACI
SIEI AAAAAAAACJ
SGGG AAAAAAAACK
SIEA AAAAAAAACL
SJJ AAAAAAAACM
SBBE AAAAAAAACN
SJG AAAAAAAACO
SJE AAAAAAAACP
SFJC AAAAAAAACQ
SFJD AAAAAAAACR
SGBJ AAAAAAAACS
SFJF AAAAAAAAAV
SGBD AAAAAAAACU
SEBH AAAAAAAACV
SBB AAAAAAAACW
SBJG AAAAAAAACX
SEJH AAAAAAAACY
SCAH AAAAAAAACZ
SIFE AAAAAAAADA
SIFC AAAAAAAADB
SCAB AAAAAAAADC
SCAE AAAAAAAADD
SGII AAAAAAAADE
SJFA AAAAAAAADF
SJFD AAAAAAAADG
SFGH AAAAAAAADH
SBGC AAAAAAAADI
SHFJ AAAAAAAADS
SDCD AAAAAAAADK
SGAG AAAAAAAADM
SGAI AAAAAAAADL
SJII AAAAAAAADO
SBDB AAAAAAAADP
SFDB AAAAAAAADQ
SDI AAAAAAAADU
SDE AAAAAAAADJ
SCIG AAAAAAAADT
SHFF AAAAAAAADR
SHFE AAAAAAAADV
