SIJJ AAAAAAAAAA
SJFI AAAAAAAAAB
SEEB AAAAAAAAAY
SJFB AAAAAAAAAD
SDAG AAAAAAAAAE
SBGC AAAAAAAAAF
SHGI AAAAAAAAAG
SHCG AAAAAAAAAH
SHAF AAAAAAAAAI
SEB AAAAAAAAAC
SGEE AAAAAAAAAK
SIAJ AAAAAAAAAL
SDA AAAAAAAAAU
SHAG AAAAAAAAAJ
SCBB AAAAAAAAAN
SEDC AAAAAAAAAO
SBBF AAAAAAAAAP
SDJC AAAAAAAAAQ
SBC AAAAAAAAAR
SJHE AAAAAAAAAS
SHBD AAAAAAAAAT
SIBG AAAAAAAAAM
SCGF AAAAAAAAAV
SIDB AAAAAAAAAW
SFFJ AAAAAAAAAX
