SCHG AAAAAAAAAH
SBAD AAAAAAAAAB
SBCG AAAAAAAAAC
SGIG AAAAAAAAAD
SECF AAAAAAAAAE
SCJC AAAAAAAAAG
SIEJ AAAAAAAAAF
SDIJ AAAAAAAAAI
SCFI AAAAAAAAAJ
SIEG AAAAAAAAAK
SFCC AAAAAAAAAL
SICC AAAAAAAAAM
SCBG AAAAAAAAAN
SJCC AAAAAAAAAO
SIIC AAAAAAAAAP
SJEA AAAAAAAAAQ
SDDJ AAAAAAAAAR
SJG AAAAAAAAAS
SBFA AAAAAAAAAT
SEBD AAAAAAAAAU
SJHF AAAAAAAAAX
SFJF AAAAAAAAAV
SFDB AAAAAAAAAW
SDHH AAAAAAAAAA
SGFG AAAAAAAAAY
