SCAH AAAAAAAAAA
SIFI AAAAAAAAAB
SHHF AAAAAAAAAC
SBCG AAAAAAAAAD
SEGD AAAAAAAAAE
SDGJ AAAAAAAAAG
SBIA AAAAAAAAAH
SBIB AAAAAAAAAI
SHAA AAAAAAAAAJ
SGEC AAAAAAAAAK
SGB AAAAAAAAAL
SCHH AAAAAAAAAM
SIII AAAAAAAAAN
SDFD AAAAAAAAAO
SFBD AAAAAAAAAX
SFJA AAAAAAAAAP
SBFB AAAAAAAAAQ
SEBJ AAAAAAAAAR
SGBC AAAAAAAAAS
SEHB AAAAAAAAAT
SEED AAAAAAAAAU
SIBG AAAAAAAAAV
SDHB AAAAAAAAAW
SDI AAAAAAAAAF
SCGA AAAAAAAAAY
