SHJG AAAAAAAAAA
SCEJ AAAAAAAAAB
SJFI AAAAAAAAAC
SEAI AAAAAAAAAD
SJFJ AAAAAAAAAE
SEGI AAAAAAAAAF
SJBI AAAAAAAAAG
SEAF AAAAAAAAAH
SEE AAAAAAAAAI
SGJ AAAAAAAAAJ
SIAA AAAAAAAAAO
SBJA AAAAAAAAAW
SEI AAAAAAAAAM
SCHI AAAAAAAAAN
SFAF AAAAAAAAAK
SIII AAAAAAAAAP
SIGF AAAAAAAAAQ
SIGH AAAAAAAAAR
SJB AAAAAAAAAS
SJE AAAAAAAAAT
SFJB AAAAAAAAAU
SHBG AAAAAAAAAV
SIBF AAAAAAAAAL
SJJJ AAAAAAAAAX
SEJA AAAAAAAAAY
