SHDG AAAAAAAAAA
SGJC AAAAAAAAAB
SIA AAAAAAAAAC
SEGJ AAAAAAAAAD
SDEI AAAAAAAAAE
SEGC AAAAAAAAAF
SBIE AAAAAAAAAG
SFAC AAAAAAAAAH
SFAE AAAAAAAAAI
SGGE AAAAAAAAAJ
SFAG AAAAAAAAAK
SFAH AAAAAAAAAL
SCDC AAAAAAAACX
SCDG AAAAAAAAAN
SHEF AAAAAAAAAO
SIGC AAAAAAAAAP
SJAI AAAAAAAAAQ
SJAD AAAAAAAAAR
SHEI AAAAAAAAAS
SEFC AAAAAAAAAT
SEFF AAAAAAAAAU
SDFJ AAAAAAAAAV
SBFF AAAAAAAAAW
SBAF AAAAAAAAAX
SFFG AAAAAAAAAY
SJIJ AAAAAAAADQ
SCGI AAAAAAAABA
SFF AAAAAAAABB
SFG AAAAAAAABC
SFE AAAAAAAABD
SCGB AAAAAAAABE
SFA AAAAAAAACG
SIJJ AAAAAAAABG
SCED AAAAAAAABH
SHJG AAAAAAAABI
SBCI AAAAAAAABJ
SDCE AAAAAAAABK
SIH AAAAAAAABL
SCI AAAAAAAABM
SCJA AAAAAAAABN
SCJC AAAAAAAABO
SCB AAAAAAAABP
SEIG AAAAAAAABQ
SBAJ AAAAAAAABR
SICJ AAAAAAAABS
SDJG AAAAAAAABT
SHAH AAAAAAAABU
SFCC AAAAAAAABV
SFCA AAAAAAAABW
SJCJ AAAAAAAABX
SJCH AAAAAAAABY
SHD AAAAAAAABZ
SHI AAAAAAAACA
SBHI AAAAAAAACB
SBDJ AAAAAAAADR
SBHG AAAAAAAACD
SEHB AAAAAAAACE
SEHI AAAAAAAACF
SFFJ AAAAAAAABF
SGDC AAAAAAAACH
SGDA AAAAAAAACI
SBEI AAAAAAAACK
SJDG AAAAAAAACL
SHHC AAAAAAAACM
SFEH AAAAAAAACN
SECF AAAAAAAACO
SFEA AAAAAAAACP
SDII AAAAAAAACQ
SIEC AAAAAAAACR
SJJD AAAAAAAADS
SDIB AAAAAAAACS
SHIC AAAAAAAACT
SCHA AAAAAAAACU
SJJ AAAAAAAACV
SGJA AAAAAAAACW
SFAI AAAAAAAAAM
SDBA AAAAAAAACY
SDBF AAAAAAAACZ
SGBF AAAAAAAADA
SEJJ AAAAAAAADB
SBH AAAAAAAADC
SIFG AAAAAAAADD
SIFD AAAAAAAADE
SCAE AAAAAAAADF
SDGD AAAAAAAADG
SEEB AAAAAAAADH
SDGH AAAAAAAADI
SEEI AAAAAAAADJ
SEEH AAAAAAAADK
SBGE AAAAAAAADL
SDCC AAAAAAAADM
SBGC AAAAAAAADN
SFGG AAAAAAAADO
SCBI AAAAAAAADP
SCFB AAAAAAAAAZ
SEDE AAAAAAAACC
SJGI AAAAAAAACJ
SBDC AAAAAAAADT
SHFC AAAAAAAADU
SHFD AAAAAAAADV
