SCEA AAAAAAAAAA
SHJH AAAAAAAAAB
SCCJ AAAAAAAAAC
SIJD AAAAAAAAAD
SJBE AAAAAAAAAE
SBAB AAAAAAAAAF
SFEF AAAAAAAAAY
SBED AAAAAAAAAG
SEEI AAAAAAAAAH
SEEH AAAAAAAAAI
SBGA AAAAAAAAAJ
SECI AAAAAAAAAK
SCJB AAAAAAAAAL
SECJ AAAAAAAAAM
SGCB AAAAAAAAAN
SCC AAAAAAAAAO
SFEC AAAAAAAAAP
SHGJ AAAAAAAAAQ
SIIJ AAAAAAAAAR
SJH AAAAAAAAAS
SDBG AAAAAAAAAT
SBHJ AAAAAAAAAU
SCDH AAAAAAAAAW
SCGE AAAAAAAAAX
SIDE AAAAAAAAAV
