SCCB AAAAAAAAAA
SIHI AAAAAAAAAB
SIHA AAAAAAAAAC
SIFI AAAAAAAAAD
SEAI AAAAAAAAAE
SCGJ AAAAAAAAAW
SGIG AAAAAAAAAF
SJFE AAAAAAAAAG
SEGB AAAAAAAAAH
SDAG AAAAAAAAAI
SCJJ AAAAAAAAAJ
SBII AAAAAAAAAK
SDF AAAAAAAAAM
SCJF AAAAAAAAAN
SIEJ AAAAAAAAAO
SHAD AAAAAAAAAP
SIEF AAAAAAAAAQ
SBG AAAAAAAAAR
SJCH AAAAAAAAAS
SJCC AAAAAAAAAT
SIA AAAAAAAAAU
SIDJ AAAAAAAAAV
SDA AAAAAAAAAL
SIAH AAAAAAAAAX
SJJA AAAAAAAAAY
