SBAA AAAAAAAAAA
SHHC AAAAAAAAAB
SDGH AAAAAAAAAC
SBGG AAAAAAAAAD
SFEH AAAAAAAAAE
SBII AAAAAAAAAF
SFGC AAAAAAAAAG
SFCB AAAAAAAAAI
SHGG AAAAAAAAAJ
SCBH AAAAAAAAAK
SJAB AAAAAAAAAL
SHC AAAAAAAAAM
SEFE AAAAAAAAAN
SJGE AAAAAAAAAO
SJGB AAAAAAAAAP
SB AAAAAAAAAW
SFDI AAAAAAAAAQ
SJIH AAAAAAAAAR
SFDC AAAAAAAAAS
SGFB AAAAAAAAAT
SCID AAAAAAAAAU
SIBJ AAAAAAAAAV
SCGF AAAAAAAAAH
SIED AAAAAAAAAX
SGDC AAAAAAAAAY
