SHDF AAAAAAAAAA
SIHC AAAAAAAAAB
SDEB AAAAAAAAAC
SDEA AAAAAAAAAD
SDEF AAAAAAAAAE
SIE AAAAAAAAAF
SEGJ AAAAAAAAAG
SEGG AAAAAAAAAH
SBIG AAAAAAAAAI
SIAF AAAAAAAAAJ
SCDH AAAAAAAAAK
SCDI AAAAAAAAAL
SHCB AAAAAAAAAM
SFAG AAAAAAAAAN
SFAJ AAAAAAAAAO
SHCH AAAAAAAAAP
SHEF AAAAAAAAAQ
SJAI AAAAAAAAAR
SEFB AAAAAAAAAT
SEFD AAAAAAAAAU
SBFB AAAAAAAAAV
SJHE AAAAAAAAAW
SJHD AAAAAAAAAX
SFFA AAAAAAAABQ
SCGG AAAAAAAAAZ
SGFI AAAAAAAABW
SGFJ AAAAAAAABB
SGF AAAAAAAADM
SFB AAAAAAAABD
SFA AAAAAAAACC
SIJI AAAAAAAABF
SHJF AAAAAAAABG
SHJC AAAAAAAABH
SHJB AAAAAAAABI
SIJD AAAAAAAABJ
SBCB AAAAAAAABK
SDCE AAAAAAAABL
SDCG AAAAAAAABM
SCI AAAAAAAABN
SCJC AAAAAAAABO
SICI AAAAAAAABP
SFJ AAAAAAAAAY
SJCJ AAAAAAAABR
SIII AAAAAAAABS
SJCC AAAAAAAABT
SJCG AAAAAAAABU
SIIB AAAAAAAABV
SCGF AAAAAAAABA
SDDF AAAAAAAABX
SFED AAAAAAAACM
SHBA AAAAAAAABZ
SGDI AAAAAAAACA
SJJD AAAAAAAACB
SJHH AAAAAAAABE
SGDB AAAAAAAACD
SHBJ AAAAAAAACE
SCCH AAAAAAAACF
SBEA AAAAAAAACG
SBEC AAAAAAAACH
SDAD AAAAAAAACI
SDAE AAAAAAAACJ
SFEJ AAAAAAAACK
SGCH AAAAAAAACL
SECI AAAAAAAAAS
SIEJ AAAAAAAACN
SDIH AAAAAAAACO
SIEA AAAAAAAACP
SIEF AAAAAAAACQ
SEI AAAAAAAACR
SDIA AAAAAAAACS
SDBJ AAAAAAAACT
SDBI AAAAAAAACU
SBBH AAAAAAAACV
SBBJ AAAAAAAACW
SGBH AAAAAAAACX
SDJB AAAAAAAACY
SEH AAAAAAAACZ
SIDF AAAAAAAADA
SIDG AAAAAAAADB
SCAJ AAAAAAAADC
SCAB AAAAAAAADD
SEEE AAAAAAAADE
SEED AAAAAAAADF
SBGF AAAAAAAADG
SHBF AAAAAAAABY
SBGH AAAAAAAADH
SFGE AAAAAAAADI
SGAG AAAAAAAADJ
SJIG AAAAAAAADK
SGAC AAAAAAAADL
SCFC AAAAAAAABC
SGDH AAAAAAAADN
SGHB AAAAAAAADO
SJGF AAAAAAAADP
SCIA AAAAAAAADQ
SCIB AAAAAAAADR
SCIE AAAAAAAADS
SDC AAAAAAAADT
SCIJ AAAAAAAADU
SHFE AAAAAAAADV
