SHDF AAAAAAAAAA
SIHF AAAAAAAAAB
SIHC AAAAAAAAAC
SEGA AAAAAAAAAD
SBAI AAAAAAAAAE
SBIB AAAAAAAAAF
SIAE AAAAAAAAAG
SIAA AAAAAAAAAH
SBAAA AAAAAAAAAI
SFAH AAAAAAAAAJ
SHCH AAAAAAAAAK
SCDD AAAAAAAAAL
SEFA AAAAAAAAAM
SGEE AAAAAAAAAN
SJHE AAAAAAAAAX
SJHC AAAAAAAABC
SCGG AAAAAAAAAQ
SJHH AAAAAAAAAR
SIJH AAAAAAAAAS
SCEF AAAAAAAAAT
SBCB AAAAAAAAAU
SDCJ AAAAAAAAAV
SBED AAAAAAAAAW
SFFG AAAAAAAAAO
SCJF AAAAAAAAAY
SEIC AAAAAAAAAZ
SICH AAAAAAAABA
SICE AAAAAAAABB
SGFD AAAAAAAAAP
SGEC AAAAAAAABD
SFCE AAAAAAAABE
SICA AAAAAAAABF
SGEF AAAAAAAABG
SJCG AAAAAAAABH
SFHI AAAAAAAABI
SHF AAAAAAAABJ
SFHA AAAAAAAABK
SBI AAAAAAAABL
SIBB AAAAAAAABM
SIBC AAAAAAAABN
SJJH AAAAAAAABO
SEHF AAAAAAAABP
SEHG AAAAAAAABQ
SEHJ AAAAAAAABR
SD AAAAAAAABS
SCEG AAAAAAAABT
SJDB AAAAAAAABU
SHHA AAAAAAAABV
SHHI AAAAAAAABW
SECF AAAAAAAABX
SFEE AAAAAAAABY
SGCE AAAAAAAABZ
SGCA AAAAAAAACA
SCHD AAAAAAAACB
SCHB AAAAAAAACC
SCHA AAAAAAAACD
SCHJ AAAAAAAACE
SHIJ AAAAAAAACF
SHII AAAAAAAACG
SHIG AAAAAAAACH
SCDB AAAAAAAACI
SJH AAAAAAAACJ
SJEC AAAAAAAACK
SDBB AAAAAAAACL
SJA AAAAAAAACM
SDBG AAAAAAAACN
SGJJ AAAAAAAACO
SJE AAAAAAAACP
SFJF AAAAAAAACQ
SFJJ AAAAAAAACR
SGBC AAAAAAAACS
SIDJ AAAAAAAACT
SBJ AAAAAAAACU
SFBB AAAAAAAACV
SE AAAAAAAACW
SBJJ AAAAAAAACX
SIFD AAAAAAAACY
SCAJ AAAAAAAACZ
SCAB AAAAAAAADA
SJFH AAAAAAAADB
SJFJ AAAAAAAADC
SDGA AAAAAAAADD
SGIG AAAAAAAADE
SDGH AAAAAAAADF
SGIB AAAAAAAADG
SFGJ AAAAAAAADH
SBGE AAAAAAAADI
SBGC AAAAAAAADJ
SFGF AAAAAAAADK
SFGG AAAAAAAADL
SGC AAAAAAAADM
SGB AAAAAAAADN
SGG AAAAAAAADO
SBDA AAAAAAAADP
SJGA AAAAAAAADQ
SFDD AAAAAAAADR
SHFH AAAAAAAADS
SDB AAAAAAAADT
SCIJ AAAAAAAADU
SDHG AAAAAAAADV
