SHDA AAAAAAAAAA
SIHE AAAAAAAAAB
SFII AAAAAAAAAC
SEGH AAAAAAAAAD
SID AAAAAAAAAE
SFIA AAAAAAAAAF
SII AAAAAAAAAG
SBAH AAAAAAAAAH
SBIC AAAAAAAAAI
SHCE AAAAAAAAAJ
SGGA AAAAAAAAAK
SCDI AAAAAAAAAL
SHCC AAAAAAAAAM
SFAJ AAAAAAAAAN
SHCH AAAAAAAAAO
SIAH AAAAAAAAAP
SJAH AAAAAAAAAQ
SEFG AAAAAAAAAR
SBFI AAAAAAAAAS
SFFE AAAAAAAAAT
SGFA AAAAAAAAAU
SGFB AAAAAAAAAV
SJHD AAAAAAAAAW
SJHB AAAAAAAABO
SIF AAAAAAAAAY
SCEG AAAAAAAAAZ
SIJC AAAAAAAABA
SIJA AAAAAAAABB
SBCC AAAAAAAABC
SIJ AAAAAAAABD
SCJJ AAAAAAAABE
SFID AAAAAAAABF
SCJD AAAAAAAABG
SCC AAAAAAAADG
SGEH AAAAAAAABI
SEIF AAAAAAAABJ
SICJ AAAAAAAABK
SHAJ AAAAAAAABL
SFCD AAAAAAAABM
SHAI AAAAAAAABN
SGFE AAAAAAAAAX
SIIH AAAAAAAABP
SHH AAAAAAAABQ
SFEJ AAAAAAAACC
SBHI AAAAAAAABS
SBHA AAAAAAAABT
SBJJ AAAAAAAABU
SGDB AAAAAAAABV
SCCE AAAAAAAABW
SJDD AAAAAAAABX
SJDI AAAAAAAABY
SBEE AAAAAAAABZ
SDAE AAAAAAAACA
SDAC AAAAAAAACB
SGCI AAAAAAAABR
SGCF AAAAAAAACD
SFEF AAAAAAAACE
SDAJ AAAAAAAACF
SHCG AAAAAAAACG
SEB AAAAAAAACH
SIEA AAAAAAAACI
SCHH AAAAAAAACJ
SGJF AAAAAAAACK
SJI AAAAAAAACL
SJEE AAAAAAAACM
SJEG AAAAAAAACN
SBBG AAAAAAAACO
SFJB AAAAAAAACP
SJFH AAAAAAAACQ
SGBG AAAAAAAACR
SDJC AAAAAAAACS
SJ AAAAAAAACT
SFBJ AAAAAAAACU
SDJG AAAAAAAACV
SBD AAAAAAAACW
SEJG AAAAAAAACX
SIDC AAAAAAAACY
SFBE AAAAAAAACZ
SE AAAAAAAADA
SIDG AAAAAAAADB
SIFG AAAAAAAADC
SCJF AAAAAAAABH
SDGE AAAAAAAADD
SEEE AAAAAAAADE
SGIH AAAAAAAADF
SFGC AAAAAAAADH
SGI AAAAAAAADI
SCFJ AAAAAAAADJ
SGAB AAAAAAAADK
SCFF AAAAAAAADL
SEDB AAAAAAAADM
SGHE AAAAAAAADN
SBDB AAAAAAAADO
SBDA AAAAAAAADP
SJH AAAAAAAADQ
SHFJ AAAAAAAADR
SCIE AAAAAAAADS
SDHC AAAAAAAADT
SDJ AAAAAAAADU
SDHF AAAAAAAADV
