SIHD AAAAAAAAAA
SJEG AAAAAAAACL
SFIH AAAAAAAAAC
SDEA AAAAAAAAAD
SEGJ AAAAAAAAAZ
SFIA AAAAAAAAAF
SCDI AAAAAAAAAG
SHCA AAAAAAAAAH
SGGE AAAAAAAAAI
SFAH AAAAAAAAAJ
SGGH AAAAAAAAAK
SHCI AAAAAAAAAL
SIAH AAAAAAAAAM
SIGA AAAAAAAAAN
SIGE AAAAAAAAAO
SICJ AAAAAAAABK
SHEJ AAAAAAAAAQ
SDFE AAAAAAAAAR
SDFJ AAAAAAAAAS
SDFH AAAAAAAAAT
SFF AAAAAAAAAU
SGFJ AAAAAAAAAV
SJHI AAAAAAAAAW
SJHH AAAAAAAAAX
SCED AAAAAAAAAY
SBAC AAAAAAAAAE
SHJC AAAAAAAABA
SHJB AAAAAAAABB
SHJA AAAAAAAABC
SBCC AAAAAAAABD
SJBB AAAAAAAABE
SCB AAAAAAAABF
SHAC AAAAAAAABG
SEIA AAAAAAAABH
SGEJ AAAAAAAABI
SEIG AAAAAAAABJ
SFCI AAAAAAAAAP
SGEC AAAAAAAABL
SGED AAAAAAAABM
SJCH AAAAAAAABN
SJCI AAAAAAAABO
SIIE AAAAAAAABP
SIID AAAAAAAABQ
SDDH AAAAAAAABR
SDDD AAAAAAAABS
SFHA AAAAAAAABT
SDDA AAAAAAAABU
SECH AAAAAAAACB
SGDG AAAAAAAABW
SD AAAAAAAABX
SHHD AAAAAAAABY
SBEJ AAAAAAAABZ
SBEA AAAAAAAACA
SGCF AAAAAAAABV
SGCB AAAAAAAACC
SHGA AAAAAAAACD
SCHJ AAAAAAAACE
SCBC AAAAAAAACF
SCBH AAAAAAAACG
SJEC AAAAAAAACH
SJED AAAAAAAACI
SBBH AAAAAAAACJ
SJEF AAAAAAAACK
SBBJ AAAAAAAAAB
SJEJ AAAAAAAACM
SDBD AAAAAAAACN
SEBD AAAAAAAACO
SFJB AAAAAAAACP
SFJD AAAAAAAACQ
SFJG AAAAAAAACR
SDJA AAAAAAAACS
SIJ AAAAAAAACT
SEJF AAAAAAAACU
SEJG AAAAAAAACV
SBJJ AAAAAAAACW
SCAH AAAAAAAACX
SCAC AAAAAAAACY
SCAD AAAAAAAACZ
SDGB AAAAAAAADA
SJAH AAAAAAAADB
SJFG AAAAAAAADC
SIJA AAAAAAAADD
SFGF AAAAAAAADE
SJIC AAAAAAAADF
SGA AAAAAAAADG
SGAI AAAAAAAADH
SCFC AAAAAAAADI
SBDI AAAAAAAADJ
SIDG AAAAAAAADK
SGHD AAAAAAAADL
SBDC AAAAAAAADM
SBDA AAAAAAAADN
SJGC AAAAAAAADO
SJJF AAAAAAAADP
SFDF AAAAAAAADQ
SFDC AAAAAAAADR
SDHC AAAAAAAADS
SDHB AAAAAAAADT
SDHE AAAAAAAADU
SHFD AAAAAAAADV
