SHDE AAAAAAAAAA
SIHG AAAAAAAAAC
SBAF AAAAAAAAAD
SEGH AAAAAAAAAE
SDED AAAAAAAAAF
SDEI AAAAAAAAAG
SHCE AAAAAAAAAH
SBAAA AAAAAAAAAI
SFAI AAAAAAAAAJ
SHAG AAAAAAAABG
SHED AAAAAAAAAL
SJAI AAAAAAAAAM
SJAD AAAAAAAAAN
SEFJ AAAAAAAAAO
SDFI AAAAAAAAAP
SBFI AAAAAAAAAQ
SFFD AAAAAAAAAR
SFFF AAAAAAAAAS
SCGI AAAAAAAAAT
SFI AAAAAAAAAU
SCGD AAAAAAAAAV
SJHH AAAAAAAABR
SHJJ AAAAAAAAAX
SCEI AAAAAAAAAY
SIJG AAAAAAAAAZ
SEAI AAAAAAAABA
SEAC AAAAAAAABB
SDCA AAAAAAAABC
SBCI AAAAAAAABD
SCA AAAAAAAABE
SCJG AAAAAAAABF
SEIF AAAAAAAAAK
SFCD AAAAAAAABH
SEIH AAAAAAAABI
SFCB AAAAAAAABJ
SDJE AAAAAAAABK
SFHJ AAAAAAAABL
SFHH AAAAAAAABM
SHJ AAAAAAAABN
SDDA AAAAAAAABO
SEHA AAAAAAAABP
SEHI AAAAAAAABQ
SFFJ AAAAAAAAAW
SJJA AAAAAAAABS
SGDC AAAAAAAABT
SHHE AAAAAAAABU
SHHC AAAAAAAABV
SHHH AAAAAAAABW
SDAD AAAAAAAABX
SDAE AAAAAAAABY
SECE AAAAAAAABZ
SGGB AAAAAAAACA
SECH AAAAAAAACB
SDAJ AAAAAAAACC
SGCB AAAAAAAACD
SDAH AAAAAAAACE
SJGC AAAAAAAACF
SHGH AAAAAAAACG
SCHE AAAAAAAACH
SEA AAAAAAAACI
SDIF AAAAAAAACJ
SHGE AAAAAAAACK
SEI AAAAAAAACL
SCEH AAAAAAAACM
SGJF AAAAAAAACN
SJED AAAAAAAACO
SDBC AAAAAAAACP
SEDI AAAAAAAADU
SGJH AAAAAAAACQ
SFJB AAAAAAAACR
SEBC AAAAAAAACS
SGBA AAAAAAAACT
SFBI AAAAAAAACU
SBC AAAAAAAACV
SBJG AAAAAAAACW
SBJA AAAAAAAACX
SBJC AAAAAAAACY
SBH AAAAAAAACZ
SFBB AAAAAAAADA
SBJH AAAAAAAADB
SFBG AAAAAAAADC
SCAI AAAAAAAADD
SCAJ AAAAAAAADE
SJFI AAAAAAAADF
SDGG AAAAAAAADG
SDGC AAAAAAAADH
SGIE AAAAAAAADI
SGAE AAAAAAAADJ
SJIG AAAAAAAADK
SGAB AAAAAAAADL
SGC AAAAAAAADM
SGB AAAAAAAADN
SGE AAAAAAAADO
SGAJ AAAAAAAADP
SEDE AAAAAAAADQ
SGHD AAAAAAAADR
SGHJ AAAAAAAADS
SBDA AAAAAAAADT
SBDF AAAAAAAAAB
SHFA AAAAAAAADV
