SIHE AAAAAAAAAA
SHDJ AAAAAAAAAB
SDED AAAAAAAAAC
SFAC AAAAAAAAAD
SIAA AAAAAAAAAE
SFCJ AAAAAAAABI
SHEF AAAAAAAAAG
SHEG AAAAAAAAAH
SIGC AAAAAAAAAI
SHEE AAAAAAAAAJ
SJAJ AAAAAAAAAK
SIGI AAAAAAAAAL
SEFB AAAAAAAAAM
SEFJ AAAAAAAAAN
SBFG AAAAAAAAAO
SGFC AAAAAAAAAP
SFJ AAAAAAAAAQ
SGFF AAAAAAAAAR
SFG AAAAAAAAAS
SFFI AAAAAAAAAT
SCGB AAAAAAAAAU
SFA AAAAAAAAAV
SCEE AAAAAAAAAW
SCEA AAAAAAAAAX
SHJH AAAAAAAAAY
SHJE AAAAAAAAAZ
SHJD AAAAAAAABA
SCEJ AAAAAAAABB
SBCC AAAAAAAABC
SEAH AAAAAAAABD
SBCI AAAAAAAABE
SDCG AAAAAAAABF
SCH AAAAAAAABG
SEIC AAAAAAAABH
SICI AAAAAAAAAF
SHAD AAAAAAAABJ
SFCI AAAAAAAABK
SGEB AAAAAAAABL
SGEE AAAAAAAABM
SGED AAAAAAAABN
SJCH AAAAAAAABO
SIIH AAAAAAAABP
SHH AAAAAAAABQ
SHI AAAAAAAABR
SDDG AAAAAAAABS
SHBG AAAAAAAABT
SGDI AAAAAAAABU
SGDB AAAAAAAABV
SCCD AAAAAAAABW
SBEH AAAAAAAABX
SJDE AAAAAAAABY
SBEG AAAAAAAABZ
SFEJ AAAAAAAACA
SECI AAAAAAAACB
SFEF AAAAAAAACC
SHGJ AAAAAAAACD
SCHA AAAAAAAACE
SDIF AAAAAAAACF
SHGA AAAAAAAACG
SHGB AAAAAAAACH
SDIE AAAAAAAACI
SHGD AAAAAAAACJ
SCBA AAAAAAAACK
SCBB AAAAAAAACL
SCBC AAAAAAAACM
SCBF AAAAAAAACN
SHIA AAAAAAAACO
SJEA AAAAAAAACP
SJEH AAAAAAAACQ
SBBG AAAAAAAACR
SJA AAAAAAAACS
SDBE AAAAAAAACT
SFJE AAAAAAAACU
SFJD AAAAAAAACV
SBJD AAAAAAAACW
SDJD AAAAAAAACX
SIDD AAAAAAAACY
SIDF AAAAAAAACZ
SIDG AAAAAAAADA
SIEC AAAAAAAADB
SGID AAAAAAAADC
SJFB AAAAAAAADD
SJFG AAAAAAAADE
SFGA AAAAAAAADF
SBGJ AAAAAAAADG
SGJ AAAAAAAADH
SCFI AAAAAAAADI
SCFC AAAAAAAADJ
SEDD AAAAAAAADK
SGHA AAAAAAAADL
SEDB AAAAAAAADM
SEDC AAAAAAAADN
SEDJ AAAAAAAADO
SFDH AAAAAAAADP
SFDD AAAAAAAADQ
SFDB AAAAAAAADR
SDF AAAAAAAADS
SDHJ AAAAAAAADT
SDHB AAAAAAAADU
SDHD AAAAAAAADV
