SCCI AAAAAAAAAA
SIC AAAAAAAAAB
SBCC AAAAAAAAAC
SGII AAAAAAAAAD
SBEB AAAAAAAAAE
SIH AAAAAAAAAF
SFIE AAAAAAAAAG
SEGC AAAAAAAAAH
SGAG AAAAAAAAAJ
SJIF AAAAAAAAAK
SGAI AAAAAAAAAL
SGF AAAAAAAAAM
SFFC AAAAAAAAAN
SCBH AAAAAAAAAO
SJAF AAAAAAAAAP
SEJA AAAAAAAAAY
SEFG AAAAAAAAAQ
SDDG AAAAAAAAAR
SDBF AAAAAAAAAS
SGBC AAAAAAAAAU
SJHF AAAAAAAAAV
SDJE AAAAAAAAAW
SBJC AAAAAAAAAT
SBJJ AAAAAAAAAX
SJEE AAAAAAAAAI
