SIHJ AAAAAAAAAA
SCAF AAAAAAAAAB
SHHB AAAAAAAAAC
SEAA AAAAAAAAAD
SEGF AAAAAAAAAE
SJFE AAAAAAAAAF
SEGC AAAAAAAAAG
SIAG AAAAAAAAAH
SCH AAAAAAAAAI
SBIF AAAAAAAAAJ
SHAB AAAAAAAAAK
SCDG AAAAAAAAAM
SJAE AAAAAAAAAN
SJCA AAAAAAAAAO
SBDI AAAAAAAAAP
SBDH AAAAAAAAAQ
SJE AAAAAAAAAR
SEBG AAAAAAAAAS
SEBA AAAAAAAAAT
SCHF AAAAAAAAAU
SGFA AAAAAAAAAV
SEFA AAAAAAAAAL
SBJB AAAAAAAAAX
SJI AAAAAAAAAW
SD AAAAAAAAAY
