SIG AAAAAAAAAA
SBAB AAAAAAAAAB
SIJ AAAAAAAAAC
SDEI AAAAAAAAAD
SIAG AAAAAAAAAF
SHCF AAAAAAAAAG
SFAC AAAAAAAAAH
SFAD AAAAAAAAAI
SCDB AAAAAAAAAJ
SHEF AAAAAAAAAK
SJAI AAAAAAAAAL
SDFJ AAAAAAAAAM
SBFB AAAAAAAAAN
SBFJ AAAAAAAAAO
SFFG AAAAAAAAAP
SFFF AAAAAAAAAQ
SFFA AAAAAAAAAR
SFFB AAAAAAAAAS
SGFI AAAAAAAAAT
SCGA AAAAAAAAAU
SDED AAAAAAAAAV
SIJB AAAAAAAAAW
SHJE AAAAAAAAAX
SIJE AAAAAAAAAY
SJBF AAAAAAAAAZ
SEAC AAAAAAAABA
SDCE AAAAAAAABB
SDCF AAAAAAAABC
SCJ AAAAAAAABD
SCE AAAAAAAABE
SGHI AAAAAAAADT
SCJG AAAAAAAABF
SGEJ AAAAAAAABG
SHAE AAAAAAAABH
SFCG AAAAAAAABI
SHAI AAAAAAAABJ
SIII AAAAAAAABK
SIIG AAAAAAAABL
SFHJ AAAAAAAABM
SHB AAAAAAAABN
SFHH AAAAAAAABO
SHH AAAAAAAABP
SHJ AAAAAAAABQ
SFHF AAAAAAAABR
SBHE AAAAAAAABS
SBHC AAAAAAAABT
SEHA AAAAAAAABU
SHC AAAAAAAABV
SIBF AAAAAAAABW
SIBD AAAAAAAABX
SJJJ AAAAAAAABY
SIBJ AAAAAAAABZ
SEHJ AAAAAAAACA
SGDC AAAAAAAACB
SHBI AAAAAAAACC
SCCE AAAAAAAACD
SGHE AAAAAAAADR
SJDB AAAAAAAACF
SDAF AAAAAAAACG
SDAE AAAAAAAACH
SFEA AAAAAAAACI
SFEB AAAAAAAACJ
SCHA AAAAAAAACK
SHGD AAAAAAAACL
SEI AAAAAAAACM
SHGG AAAAAAAACN
SHID AAAAAAAACO
SJEA AAAAAAAACP
SGJF AAAAAAAACQ
SDBH AAAAAAAACR
SGJJ AAAAAAAACS
SBBB AAAAAAAACT
SEBG AAAAAAAACU
SFJE AAAAAAAACV
SFJG AAAAAAAACW
SIEG AAAAAAAACX
SBJE AAAAAAAACY
SH AAAAAAAACZ
SIEE AAAAAAAADA
SDJE AAAAAAAADB
SEJI AAAAAAAADC
SEJD AAAAAAAADD
SEJB AAAAAAAADE
SCAE AAAAAAAADF
SJFI AAAAAAAADG
SGII AAAAAAAADH
SDGH AAAAAAAADI
SGIC AAAAAAAADJ
SBGC AAAAAAAADK
SJID AAAAAAAADL
SGAD AAAAAAAADM
SJIG AAAAAAAADN
SGAA AAAAAAAADO
SJGJ AAAAAAAADP
SJGH AAAAAAAADQ
SEDC AAAAAAAACE
SBDA AAAAAAAADS
SJGE AAAAAAAAAE
SDHA AAAAAAAADU
SCIH AAAAAAAADV
