SIFD AAAAAAAAAA
SCAA AAAAAAAAAB
SIHB AAAAAAAAAC
SEEF AAAAAAAAAD
SFIG AAAAAAAAAL
SDAA AAAAAAAAAF
SGAD AAAAAAAAAG
SGEJ AAAAAAAAAH
SHCB AAAAAAAAAO
SHAE AAAAAAAAAJ
SFCG AAAAAAAAAK
SEGB AAAAAAAAAE
SCDG AAAAAAAAAM
SGG AAAAAAAAAN
SDIH AAAAAAAAAI
SIGF AAAAAAAAAP
SGGD AAAAAAAAAQ
SHIG AAAAAAAAAR
SHID AAAAAAAAAS
SFHI AAAAAAAAAT
SBJE AAAAAAAAAU
SHFJ AAAAAAAAAV
SGAC AAAAAAAAAW
SC AAAAAAAAAX
SGDD AAAAAAAAAY
