SIHD AAAAAAAAAA
SIHG AAAAAAAAAB
SFIE AAAAAAAAAC
SBII AAAAAAAAAD
SIAE AAAAAAAAAX
SBAAA AAAAAAAAAF
SCDG AAAAAAAAAG
SIAI AAAAAAAAAH
SJAJ AAAAAAAAAI
SEBE AAAAAAAAAJ
SDFB AAAAAAAAAK
SBEE AAAAAAAADS
SBFE AAAAAAAAAL
SJDB AAAAAAAAAM
SBFI AAAAAAAAAN
SBFF AAAAAAAAAO
SGFA AAAAAAAAAP
SCGJ AAAAAAAAAQ
SFG AAAAAAAAAR
SFFI AAAAAAAAAS
SCED AAAAAAAAAT
SCEA AAAAAAAAAU
SHJH AAAAAAAAAV
SEAJ AAAAAAAAAW
SBCG AAAAAAAAAY
SBCE AAAAAAAAAZ
SBCI AAAAAAAABA
SJBI AAAAAAAABB
SCJH AAAAAAAABC
SCJJ AAAAAAAABD
SCJC AAAAAAAABE
SCB AAAAAAAABF
SFCH AAAAAAAABG
SFCF AAAAAAAABH
SGEC AAAAAAAABI
SFCB AAAAAAAABJ
SFCC AAAAAAAABK
SDHJ AAAAAAAADT
SIIH AAAAAAAABL
SJCA AAAAAAAABM
SHA AAAAAAAABN
SHG AAAAAAAABO
SDDG AAAAAAAABP
SFHF AAAAAAAABQ
SFHJ AAAAAAAABR
SHBD AAAAAAAABS
SIBF AAAAAAAABT
SGDD AAAAAAAABU
SJJC AAAAAAAABV
SCCE AAAAAAAABW
SCCI AAAAAAAABX
SBEI AAAAAAAABY
SHHA AAAAAAAABZ
SJDF AAAAAAAACA
SBED AAAAAAAACB
SHHH AAAAAAAACC
SBEF AAAAAAAACD
SECD AAAAAAAACE
SECI AAAAAAAACF
SFEA AAAAAAAACG
SHGH AAAAAAAACH
SEF AAAAAAAACI
SCHD AAAAAAAACJ
SCHE AAAAAAAACK
SDIF AAAAAAAACL
SHGD AAAAAAAACM
SEJ AAAAAAAACN
SHGF AAAAAAAACO
SHIF AAAAAAAACP
SFAB AAAAAAAAAE
SJEF AAAAAAAACR
SBBD AAAAAAAACS
SBBA AAAAAAAACT
SFJB AAAAAAAACU
SGBE AAAAAAAACV
SDJA AAAAAAAACW
SBA AAAAAAAACX
SBJA AAAAAAAACY
SBH AAAAAAAACZ
SEJE AAAAAAAADA
SCAJ AAAAAAAADB
SJBB AAAAAAAADC
SIFI AAAAAAAADD
SDGE AAAAAAAADE
SDGB AAAAAAAADF
SDGJ AAAAAAAADG
SFGI AAAAAAAADH
SFGC AAAAAAAADJ
SFGG AAAAAAAADK
SGAE AAAAAAAADL
SCIB AAAAAAAADM
SEDE AAAAAAAADN
SBDI AAAAAAAADO
SBDF AAAAAAAADP
SFDH AAAAAAAADQ
SFDA AAAAAAAADR
SDE AAAAAAAADI
SJEC AAAAAAAACQ
SHFC AAAAAAAADU
SDHD AAAAAAAADV
