SHDA AAAAAAAAAA
SIHB AAAAAAAAAB
SDEB AAAAAAAAAC
SDEA AAAAAAAAAD
SEGI AAAAAAAAAE
SFIA AAAAAAAAAF
SBII AAAAAAAAAG
SBIJ AAAAAAAAAH
SBID AAAAAAAAAI
SBIA AAAAAAAAAJ
SJBC AAAAAAAAAK
SIAG AAAAAAAAAL
SIAF AAAAAAAAAM
SHCG AAAAAAAAAN
SIAC AAAAAAAAAO
SFAF AAAAAAAAAP
SGGI AAAAAAAAAQ
SHCI AAAAAAAAAR
SIAI AAAAAAAAAS
SHEF AAAAAAAAAT
SHEG AAAAAAAAAU
SIGC AAAAAAAAAV
SDFF AAAAAAAAAW
SEFF AAAAAAAAAX
SEFH AAAAAAAAAY
SDFI AAAAAAAAAZ
SFJA AAAAAAAABA
SGFB AAAAAAAABC
SGFG AAAAAAAABD
SFD AAAAAAAABE
SFE AAAAAAAABF
SIJH AAAAAAAABG
SCEF AAAAAAAABH
SCEA AAAAAAAABI
SIJC AAAAAAAABJ
SIJA AAAAAAAABK
SBCA AAAAAAAABL
SBCD AAAAAAAABM
SBCE AAAAAAAABN
SCD AAAAAAAABO
SCJC AAAAAAAABP
SCJF AAAAAAAABQ
SHAC AAAAAAAABR
SEIG AAAAAAAABS
SHAG AAAAAAAABT
SICE AAAAAAAABU
SFCG AAAAAAAABV
SDHJ AAAAAAAADV
SDDI AAAAAAAABW
SDDJ AAAAAAAABX
SECG AAAAAAAABZ
SIDD AAAAAAAACA
SHGA AAAAAAAACP
SJJE AAAAAAAACB
SIBI AAAAAAAACC
SJJA AAAAAAAACD
SJGI AAAAAAAADQ
SJDF AAAAAAAACF
SJDE AAAAAAAACG
SBEG AAAAAAAACH
SDAG AAAAAAAACI
SDAD AAAAAAAACJ
SDAE AAAAAAAACK
SFEI AAAAAAAACL
SGCI AAAAAAAACM
SFED AAAAAAAACN
SHGJ AAAAAAAACO
SIEB AAAAAAAACW
SDIC AAAAAAAACQ
SHIA AAAAAAAACR
SHIE AAAAAAAACS
SJH AAAAAAAACT
SJI AAAAAAAACU
SJED AAAAAAAACV
SDIG AAAAAAAABY
SJG AAAAAAAACX
SEBF AAAAAAAACY
SFJC AAAAAAAACZ
SFJH AAAAAAAADA
SIDJ AAAAAAAADB
SEJB AAAAAAAADC
SEJC AAAAAAAADD
SBJJ AAAAAAAADE
SIFC AAAAAAAADF
SCAE AAAAAAAADG
SDGB AAAAAAAADH
SJFA AAAAAAAADI
SGIG AAAAAAAADJ
SBGE AAAAAAAADK
SBGI AAAAAAAADL
SJIE AAAAAAAADM
SJIG AAAAAAAADN
SGAA AAAAAAAADO
SGHA AAAAAAAADP
SEDC AAAAAAAACE
SBDC AAAAAAAADR
SFDH AAAAAAAADS
SDE AAAAAAAADT
SDF AAAAAAAADU
SJEC AAAAAAAABB
