SHDC AAAAAAAAAA
SIHD AAAAAAAAAB
SHDJ AAAAAAAAAC
SIC AAAAAAAAAD
SEGJ AAAAAAAAAE
SII AAAAAAAAAF
SFIC AAAAAAAAAG
SCDJ AAAAAAAAAH
SIAE AAAAAAAAAI
SGGG AAAAAAAAAJ
SGGF AAAAAAAAAK
SCDB AAAAAAAAAL
SCDA AAAAAAAAAM
SIAJ AAAAAAAAAN
SCDD AAAAAAAAAO
SJAI AAAAAAAAAP
SJAE AAAAAAAAAQ
SDFE AAAAAAAAAR
SEFJ AAAAAAAAAS
SBFD AAAAAAAAAT
SBFG AAAAAAAAAU
SGFB AAAAAAAAAV
SJHJ AAAAAAAAAW
SIJC AAAAAAAAAX
SJBD AAAAAAAAAY
SJBG AAAAAAAAAZ
SBCA AAAAAAAABA
SEAA AAAAAAAABB
SEGG AAAAAAAABC
SCJJ AAAAAAAABD
SDJB AAAAAAAABE
SCJD AAAAAAAABF
SCJE AAAAAAAABG
SICJ AAAAAAAABH
SICE AAAAAAAABI
SEII AAAAAAAABJ
SHAI AAAAAAAABK
SIIJ AAAAAAAABL
SHC AAAAAAAABM
SFHC AAAAAAAABN
SDDG AAAAAAAABO
SIDD AAAAAAAABP
SIBB AAAAAAAABQ
SJJJ AAAAAAAABR
SGDB AAAAAAAABS
SGDA AAAAAAAABT
SCCC AAAAAAAABU
SCCE AAAAAAAABV
SCCD AAAAAAAABW
SJDE AAAAAAAABX
SJDJ AAAAAAAABY
SHHI AAAAAAAABZ
SDAA AAAAAAAACA
SDIJ AAAAAAAACB
SCHA AAAAAAAACC
SHID AAAAAAAACD
SJEB AAAAAAAACE
SBBC AAAAAAAACF
SEBF AAAAAAAACG
SEBD AAAAAAAACH
SFJB AAAAAAAACI
SFJE AAAAAAAACJ
SGBB AAAAAAAACK
SBC AAAAAAAACL
SDJE AAAAAAAACM
SEJI AAAAAAAACN
SDJI AAAAAAAACO
SIDC AAAAAAAACP
SBJI AAAAAAAACQ
SFBD AAAAAAAACR
SCAI AAAAAAAACS
SCAH AAAAAAAACT
SCAD AAAAAAAACU
SCAG AAAAAAAACV
SIFI AAAAAAAACW
SEEE AAAAAAAACX
SEED AAAAAAAACY
SGII AAAAAAAACZ
SGIE AAAAAAAADA
SBCH AAAAAAAADB
SEEI AAAAAAAADC
SHEC AAAAAAAADD
SFGC AAAAAAAADE
SFGF AAAAAAAADF
SDF AAAAAAAADP
SGH AAAAAAAADH
SGAA AAAAAAAADI
SGG AAAAAAAADJ
SGAJ AAAAAAAADK
SEDD AAAAAAAADL
SGHE AAAAAAAADM
SFDD AAAAAAAADN
SDD AAAAAAAADO
SHFI AAAAAAAADG
SCIB AAAAAAAADQ
SCIE AAAAAAAADR
SCIG AAAAAAAADS
SDC AAAAAAAADT
SHFG AAAAAAAADU
SDJ AAAAAAAADV
