SJEG AAAAAAAAAA
SIC AAAAAAAAAB
SDEC AAAAAAAAAC
SEGJ AAAAAAAABC
SFIB AAAAAAAAAE
SFIG AAAAAAAAAF
SHAC AAAAAAAAAG
SBIE AAAAAAAAAH
SIAF AAAAAAAAAI
SFAD AAAAAAAAAJ
SIAB AAAAAAAAAK
SFAF AAAAAAAAAL
SFAG AAAAAAAAAM
SFAH AAAAAAAAAN
SJAJ AAAAAAAAAO
SIGH AAAAAAAAAP
SHEJ AAAAAAAAAQ
SHEI AAAAAAAAAS
SDFA AAAAAAAAAT
SDFJ AAAAAAAAAU
SBFA AAAAAAAAAV
SFIH AAAAAAAAAW
SBFE AAAAAAAAAX
SFFF AAAAAAAAAY
SFD AAAAAAAAAZ
SIJJ AAAAAAAABA
SHJF AAAAAAAABB
SBAC AAAAAAAAAD
SIJF AAAAAAAABD
SBCE AAAAAAAABE
SJBH AAAAAAAABF
SDCG AAAAAAAABG
SCH AAAAAAAABH
SCE AAAAAAAABI
SCJA AAAAAAAABJ
SEIB AAAAAAAABK
SICH AAAAAAAABL
SIID AAAAAAAABM
SEJG AAAAAAAABN
SFHC AAAAAAAABO
SIBC AAAAAAAABP
SIBE AAAAAAAABQ
SJJE AAAAAAAABR
SGDE AAAAAAAABS
SDH AAAAAAAADV
SHHG AAAAAAAABT
SHHC AAAAAAAABU
SJDI AAAAAAAABV
SHHJ AAAAAAAABW
SDAG AAAAAAAABX
SFEI AAAAAAAABY
SECH AAAAAAAABZ
SGCC AAAAAAAACA
SFEA AAAAAAAACB
SCHD AAAAAAAACC
SDII AAAAAAAACD
SDIG AAAAAAAACM
SEI AAAAAAAACF
SIJA AAAAAAAACG
SCBF AAAAAAAACH
SHIC AAAAAAAACI
SHIG AAAAAAAACJ
SCDB AAAAAAAACK
SJEE AAAAAAAACL
SHGA AAAAAAAACE
SBBE AAAAAAAACN
SJEJ AAAAAAAACO
SJA AAAAAAAACP
SDBD AAAAAAAACQ
SEBF AAAAAAAACR
SFJC AAAAAAAACS
SEBE AAAAAAAACT
SDJA AAAAAAAACU
SCHH AAAAAAAACV
SFDF AAAAAAAADO
SIDA AAAAAAAACW
SIFD AAAAAAAACX
SIFC AAAAAAAACY
SEED AAAAAAAACZ
SEEB AAAAAAAADA
SGIA AAAAAAAADB
SJIE AAAAAAAADC
SCFH AAAAAAAADD
SJIB AAAAAAAADE
SCFG AAAAAAAADF
SJII AAAAAAAADG
SCFC AAAAAAAADH
SGAD AAAAAAAADI
SGDF AAAAAAAADK
SBDI AAAAAAAADL
SJGE AAAAAAAADM
SJGC AAAAAAAADN
SDHE AAAAAAAADJ
SFDE AAAAAAAADP
SFDD AAAAAAAADQ
SDE AAAAAAAADR
SHFI AAAAAAAADS
SCIH AAAAAAAADT
SDHC AAAAAAAADU
SHFG AAAAAAAAAR
