SIHH AAAAAAAAAA
SHJA AAAAAAAAAB
SBEH AAAAAAAAAC
SEEC AAAAAAAAAD
SDAB AAAAAAAAAE
SFED AAAAAAAAAF
SFEC AAAAAAAAAG
SIAE AAAAAAAAAH
SJIG AAAAAAAAAI
SHAD AAAAAAAAAJ
SDJG AAAAAAAAAK
SHAH AAAAAAAAAL
SCHJ AAAAAAAAAM
SHGF AAAAAAAAAN
SJAJ AAAAAAAAAO
SJCA AAAAAAAAAP
SHE AAAAAAAAAQ
SJEJ AAAAAAAAAR
SCIC AAAAAAAAAS
SJJI AAAAAAAAAT
SEHE AAAAAAAAAU
SIDA AAAAAAAAAV
SFBC AAAAAAAAAW
SHFG AAAAAAAAAX
SGDA AAAAAAAAAY
