SFGF AAAAAAAADJ
SHDJ AAAAAAAAAB
SEGH AAAAAAAAAC
SIE AAAAAAAAAD
SJC AAAAAAAAAE
SHCA AAAAAAAAAF
SBAAA AAAAAAAAAG
SGGJ AAAAAAAAAH
SHCJ AAAAAAAAAI
SCDE AAAAAAAADD
SIGH AAAAAAAAAK
SIGJ AAAAAAAAAL
SJAC AAAAAAAAAM
SEFA AAAAAAAAAN
SDFC AAAAAAAAAO
SFCG AAAAAAAABG
SEFI AAAAAAAAAQ
SBFD AAAAAAAAAR
SGFA AAAAAAAAAS
SGFB AAAAAAAAAT
SCGE AAAAAAAAAU
SCGD AAAAAAAAAV
SFB AAAAAAAAAW
SHJH AAAAAAAAAX
SJGC AAAAAAAADR
SJBE AAAAAAAAAY
SJBD AAAAAAAAAZ
SJBF AAAAAAAABA
SBCI AAAAAAAABB
SCJB AAAAAAAABC
SCC AAAAAAAABD
SICI AAAAAAAABE
SGEA AAAAAAAABF
SEIJ AAAAAAAAAP
SHAH AAAAAAAABH
SHHJ AAAAAAAACC
SICB AAAAAAAABJ
SJCJ AAAAAAAABK
SIIG AAAAAAAABL
SIIE AAAAAAAABM
SIIC AAAAAAAABN
SHE AAAAAAAABO
SB AAAAAAAABP
SHJ AAAAAAAABQ
SEJE AAAAAAAABR
SBHG AAAAAAAABS
SEHA AAAAAAAABT
SJJI AAAAAAAABU
SJJC AAAAAAAABV
SGDA AAAAAAAABW
SCCE AAAAAAAABX
SJDC AAAAAAAABY
SHHG AAAAAAAABZ
SHHB AAAAAAAACA
SJDI AAAAAAAACB
SBEG AAAAAAAABI
SDAD AAAAAAAACD
SECI AAAAAAAACE
SFEG AAAAAAAACF
SGCA AAAAAAAACG
SDAI AAAAAAAACH
SEG AAAAAAAACI
SIEI AAAAAAAACJ
SHGE AAAAAAAACK
SDIA AAAAAAAACL
SHIJ AAAAAAAACM
SCBA AAAAAAAACN
SHIA AAAAAAAACO
SDBJ AAAAAAAACP
SGJA AAAAAAAACQ
SJEG AAAAAAAACR
SJEI AAAAAAAACS
SDBE AAAAAAAACU
SGBH AAAAAAAACV
SGBG AAAAAAAACW
SEBJ AAAAAAAACX
SBB AAAAAAAACY
SIDJ AAAAAAAACZ
SBJF AAAAAAAADA
SBJB AAAAAAAADB
SIDA AAAAAAAADC
SIAH AAAAAAAAAJ
SFBE AAAAAAAADE
SCAD AAAAAAAADF
SJFH AAAAAAAADG
SEEE AAAAAAAADH
SDGJ AAAAAAAADI
SBGJ AAAAAAAAAA
SGAG AAAAAAAADK
SGAF AAAAAAAADL
SGA AAAAAAAADM
SEFE AAAAAAAADN
SEDF AAAAAAAADO
SJGH AAAAAAAADP
SJGB AAAAAAAADQ
SEDI AAAAAAAACT
SFDA AAAAAAAADS
SDFD AAAAAAAADT
SCID AAAAAAAADU
SCIF AAAAAAAADV
