SIHI AAAAAAAAAA
SIHA AAAAAAAAAB
SBAB AAAAAAAAAC
SEGE AAAAAAAAAY
SEGA AAAAAAAAAE
SBIE AAAAAAAAAF
SBIG AAAAAAAAAG
SBIA AAAAAAAAAH
SCDJ AAAAAAAAAI
SGGB AAAAAAAAAJ
SIAA AAAAAAAAAK
SGGI AAAAAAAAAL
SHCI AAAAAAAAAM
SCDE AAAAAAAAAN
SIGC AAAAAAAAAO
SJAF AAAAAAAAAQ
SEFA AAAAAAAAAR
SFCD AAAAAAAABM
SEIH AAAAAAAAAP
SJHG AAAAAAAAAU
SJHC AAAAAAAAAV
SHAI AAAAAAAABN
SIJG AAAAAAAAAW
SJBE AAAAAAAAAX
SDEJ AAAAAAAAAD
SJBF AAAAAAAAAZ
SEAC AAAAAAAABA
SEAA AAAAAAAABB
SBCI AAAAAAAABC
SDCE AAAAAAAABD
SEAE AAAAAAAABE
SJBJ AAAAAAAABF
SCJJ AAAAAAAABG
SCA AAAAAAAABH
SI AAAAAAAABI
SCB AAAAAAAABJ
SEIB AAAAAAAABK
SGEA AAAAAAAABL
SICG AAAAAAAAAS
SICF AAAAAAAAAT
SGEG AAAAAAAABO
SFCA AAAAAAAABP
SDDE AAAAAAAABQ
SFHB AAAAAAAABR
SFHD AAAAAAAABS
SIBE AAAAAAAABT
SHHG AAAAAAAABU
SDAG AAAAAAAABV
SECC AAAAAAAABW
SFEI AAAAAAAABX
SBDF AAAAAAAADP
SIEJ AAAAAAAABZ
SHGB AAAAAAAACA
SHGC AAAAAAAACB
SCBB AAAAAAAACC
SHID AAAAAAAACD
SHIE AAAAAAAACE
SJJ AAAAAAAACF
SDBJ AAAAAAAACG
SJEB AAAAAAAACH
SJEF AAAAAAAACI
SJB AAAAAAAACJ
SJA AAAAAAAACK
SDID AAAAAAAACL
SFJE AAAAAAAACM
SGBI AAAAAAAACN
SGBD AAAAAAAACO
SBJE AAAAAAAACP
SFBH AAAAAAAACQ
SIDJ AAAAAAAACR
SBD AAAAAAAACS
SDJD AAAAAAAACT
SFBG AAAAAAAACU
SIFG AAAAAAAACV
SIFC AAAAAAAACW
SCAA AAAAAAAACX
SIFI AAAAAAAACY
SDGA AAAAAAAACZ
SGIF AAAAAAAADA
SJFD AAAAAAAADB
SDGJ AAAAAAAADC
SBGF AAAAAAAADD
SFGH AAAAAAAADE
SBGA AAAAAAAADF
SGAA AAAAAAAADG
SJIC AAAAAAAADH
SGB AAAAAAAADI
SGD AAAAAAAADJ
SGG AAAAAAAADK
SEDF AAAAAAAADL
SEDA AAAAAAAADM
SBDC AAAAAAAADN
SGHI AAAAAAAADO
SEDI AAAAAAAABY
SFDA AAAAAAAADQ
SDE AAAAAAAADR
SHFH AAAAAAAADS
SCIH AAAAAAAADT
SDI AAAAAAAADU
SDJ AAAAAAAADV
