SHDF AAAAAAAAAA
SHHD AAAAAAAAAB
SDCC AAAAAAAAAG
SDCD AAAAAAAAAH
SFIF AAAAAAAAAE
SBGD AAAAAAAAAF
SJDH AAAAAAAAAC
SEAG AAAAAAAAAD
SDIA AAAAAAAAAW
SCDJ AAAAAAAAAI
SHCB AAAAAAAAAJ
SBAAA AAAAAAAAAK
SGAJ AAAAAAAAAL
SHII AAAAAAAAAM
SCIF AAAAAAAAAN
SHIG AAAAAAAAAO
SHEI AAAAAAAAAP
SJEA AAAAAAAAAQ
SJHC AAAAAAAAAS
SBD AAAAAAAAAT
SCGH AAAAAAAAAU
SCIH AAAAAAAAAV
SEJE AAAAAAAAAR
SCGC AAAAAAAAAX
SHFD AAAAAAAAAY
