SHJA AAAAAAAAAA
SEEC AAAAAAAAAB
SIJ AAAAAAAAAC
SJFC AAAAAAAAAD
SJAI AAAAAAAAAN
SECF AAAAAAAAAF
SFGB AAAAAAAAAG
SGI AAAAAAAAAH
SICI AAAAAAAAAI
SEIF AAAAAAAAAJ
SGGE AAAAAAAAAK
SEI AAAAAAAAAL
SCDE AAAAAAAAAM
SCBE AAAAAAAAAE
SCIF AAAAAAAAAW
SJEA AAAAAAAAAP
SJEB AAAAAAAAAQ
SJC AAAAAAAAAR
SGJE AAAAAAAAAS
SDJB AAAAAAAAAT
SGFC AAAAAAAAAU
SJJH AAAAAAAAAV
SGFG AAAAAAAAAO
SJJF AAAAAAAAAX
SEJB AAAAAAAAAY
