1f3oa AAAAAAAAAA
1g6ha AAAAAAAAAB
1e69a AAAAAAAAAC
1g291 AAAAAAAAAD
1b0ua AAAAAAAAAE
1f2ua AAAAAAAAAF
