1am5 AAAAAAAAAA
1lyaa AAAAAAAAAB
1psn AAAAAAAAAC
2jxra AAAAAAAAAD
4cms AAAAAAAAAE
2apr AAAAAAAAAF
1mpp AAAAAAAAAG
5pep AAAAAAAAAH
2asi AAAAAAAAAI
4ape AAAAAAAAAJ
1bbs AAAAAAAAAK
1smra AAAAAAAAAL
3app AAAAAAAAAM
