1tn4 AAAAAAAAAA
1aj4 AAAAAAAAAB
5tnc AAAAAAAAAC
3cln AAAAAAAAAD
1br1b AAAAAAAAAE
2scpa AAAAAAAAAF
4cln AAAAAAAAAG
2sas AAAAAAAAAH
