2cdv AAAAAAAAAA
2cy3 AAAAAAAAAB
1wad AAAAAAAAAC
3cyr AAAAAAAAAD
1aqe AAAAAAAAAE
2cym AAAAAAAAAF
