1cc5 AAAAAAAAAA
1cor AAAAAAAAAB
1a8c AAAAAAAAAC
1ayg AAAAAAAAAD
1cch AAAAAAAAAE
351c AAAAAAAAAF
