2c2c AAAAAAAAAA
5cytr AAAAAAAAAB
1ccr AAAAAAAAAC
1ycc AAAAAAAAAD
155c AAAAAAAAAE
2pcbb AAAAAAAAAF
1hroa AAAAAAAAAG
1c2ra AAAAAAAAAH
1yea AAAAAAAAAI
1cry AAAAAAAAAJ
1cxc AAAAAAAAAK
