1fsb AAAAAAAAAA
1epi AAAAAAAAAK
1rfnb AAAAAAAAAC
1ixa AAAAAAAAAD
1hre AAAAAAAAAE
1urk AAAAAAAAAF
1dan2 AAAAAAAAAG
1dan1 AAAAAAAAAH
1hcgb AAAAAAAAAI
1apo AAAAAAAAAJ
1esl AAAAAAAAAB
4tgf AAAAAAAAAL
