1lz1 AAAAAAAAAA
2eql AAAAAAAAAG
1lz3 AAAAAAAAAC
1hhl AAAAAAAAAD
1lzt AAAAAAAAAE
1alc AAAAAAAAAF
1hfya AAAAAAAAAB
1ghla AAAAAAAAAH
1jug AAAAAAAAAJ
1hfx AAAAAAAAAI
1lmn AAAAAAAAAK
1hml AAAAAAAAAL
