1mh1 AAAAAAAAAA
5p21 AAAAAAAAAB
1zbda AAAAAAAAAC
1guaa AAAAAAAAAD
1ftn AAAAAAAAAE
1kao AAAAAAAAAF
1etu AAAAAAAAAG
1a4ra AAAAAAAAAH
