1tlk AAAAAAAAAA
1itbb2 AAAAAAAAAB
1itbb3 AAAAAAAAAC
2ncm AAAAAAAAAD
1vcaa AAAAAAAAAE
1nct AAAAAAAAAF
1tit AAAAAAAAAG
1zxq AAAAAAAAAH
1wit AAAAAAAAAI
