1knt AAAAAAAAAA
1tfxc AAAAAAAAAB
5pti AAAAAAAAAC
1tap AAAAAAAAAD
1dem AAAAAAAAAE
1bf0 AAAAAAAAAF
1shp AAAAAAAAAG
1dtx AAAAAAAAAH
1aapa AAAAAAAAAI
1dtk AAAAAAAAAJ
