1avba AAAAAAAAAA
2ltn AAAAAAAAAB
1lgc AAAAAAAAAC
5cna AAAAAAAAAD
1len AAAAAAAAAE
1lu1 AAAAAAAAAF
1wbla AAAAAAAAAG
1loe AAAAAAAAAH
1sbf AAAAAAAAAI
1lte AAAAAAAAAJ
1lec AAAAAAAAAK
2pela AAAAAAAAAL
