1fdr AAAAAAAAAA
1qfza AAAAAAAAAB
2cnd AAAAAAAAAC
1ndh AAAAAAAAAD
1que AAAAAAAAAE
1qfja AAAAAAAAAF
1a8p AAAAAAAAAG
