1bc4 AAAAAAAAAA
1bsr AAAAAAAAAB
7rsa AAAAAAAAAC
1b1ia AAAAAAAAAD
1rra AAAAAAAAAE
1agi AAAAAAAAAF
