1vna AAAAAAAAAA
1aho AAAAAAAAAF
1bmr AAAAAAAAAC
1cn2 AAAAAAAAAD
2b3ca AAAAAAAAAE
1lqq AAAAAAAAAB
2sn3 AAAAAAAAAG
1nrb AAAAAAAAAH
