1apf AAAAAAAAAA
1ahl AAAAAAAAAB
1atx AAAAAAAAAC
1bds AAAAAAAAAD
1sh1 AAAAAAAAAE
