1ce2a AAAAAAAAAA
1dsn AAAAAAAAAB
1a8e AAAAAAAAAC
1dot AAAAAAAAAD
1ovt AAAAAAAAAE
1tfd AAAAAAAAAF
1b1xa AAAAAAAAAG
