TYSY_CRYNE AAAAAAAAAA
TYSY_MYCGA AAAAAAAAAB
TYSY_METFL AAAAAAAAAC
TYSY_VZVD AAAAAAAAAD
DRTS_CRIFA AAAAAAAAAE
1b49_A AAAAAAAAAF
TYSY_HAEDU AAAAAAAAAG
DRTS_TOXGO AAAAAAAAAH
