seq116 AAAAAAAAAA
seq014 AAAAAAAAAB
seq035 AAAAAAAAAC
seq036 AAAAAAAAAD
seq019 AAAAAAAAAE
seq030 AAAAAAAAAF
seq033 AAAAAAAAAG
seq078 AAAAAAAAAH
seq059 AAAAAAAAAI
seq056 AAAAAAAAAJ
seq073 AAAAAAAAAK
seq093 AAAAAAAAAL
seq096 AAAAAAAAAM
seq065 AAAAAAAAAN
seq064 AAAAAAAAAO
seq062 AAAAAAAAAP
seq008 AAAAAAAAAQ
seq129 AAAAAAAAAR
seq044 AAAAAAAAAS
seq123 AAAAAAAAAT
seq101 AAAAAAAAAU
seq081 AAAAAAAAAV
seq086 AAAAAAAAAW
