seq012 AAAAAAAAAA
seq013 AAAAAAAAAB
seq010 AAAAAAAAAC
seq011 AAAAAAAAAD
seq016 AAAAAAAAAE
seq017 AAAAAAAAAF
seq014 AAAAAAAAAG
seq015 AAAAAAAAAH
seq018 AAAAAAAAAI
seq019 AAAAAAAAAJ
seq008 AAAAAAAAAK
seq001 AAAAAAAAAL
seq003 AAAAAAAAAM
seq002 AAAAAAAAAN
seq005 AAAAAAAAAO
seq004 AAAAAAAAAP
seq007 AAAAAAAAAQ
seq006 AAAAAAAAAR
seq009 AAAAAAAAAS
seq022 AAAAAAAAAT
seq021 AAAAAAAAAU
seq020 AAAAAAAAAV
