seq010 AAAAAAAAAC
seq001 AAAAAAAAAB
seq003 AAAAAAAAAA
seq002 AAAAAAAAAD
seq005 AAAAAAAAAE
seq004 AAAAAAAAAF
seq007 AAAAAAAAAG
seq006 AAAAAAAAAH
seq009 AAAAAAAAAI
seq008 AAAAAAAAAJ
