seq109 AAAAAAAAAA
seq048 AAAAAAAAAB
seq046 AAAAAAAAAC
seq105 AAAAAAAAAD
seq051 AAAAAAAAAJ
seq004 AAAAAAAAAL
seq064 AAAAAAAAAF
seq017 AAAAAAAAAG
seq002 AAAAAAAAAH
seq015 AAAAAAAAAI
seq032 AAAAAAAAAK
seq033 AAAAAAAAAE
