Q95MQ1 AAAAAAAAAA
Q8SPX1 AAAAAAAAAB
Q3U6A8 AAAAAAAAAC
Q07108 AAAAAAAAAD
Q5M851 AAAAAAAAAE
