1bb9_ AAAAAAAAAA
1ue9_A AAAAAAAAAB
1hjd_A AAAAAAAAAD
1ov3_A AAAAAAAAAC
1abo_A AAAAAAAAAE
1ycs_B AAAAAAAAAF
1ihv_A AAAAAAAAAG
1pht_ AAAAAAAAAH
