1buc_A AAAAAAAAAA
P45954 AAAAAAAAAL
P79274 AAAAAAAAAC
Q8jzn5 AAAAAAAAAD
Q9kje8 AAAAAAAAAE
Q10535 AAAAAAAAAF
1rx0_A AAAAAAAAAG
P76200 AAAAAAAAAH
P71539 AAAAAAAAAI
Q92947 AAAAAAAAAJ
1ivh_A AAAAAAAAAK
1r2j_A AAAAAAAAAB
Q9vsa3 AAAAAAAAAM
