A0DPS3 AAAAAAAAAA
P50082 AAAAAAAAAB
Q6FU08 AAAAAAAAAC
Q09786 AAAAAAAAAD
Q4QAF9 AAAAAAAAAE
Q8UWJ8 AAAAAAAAAF
