seq049 AAAAAAAAAO
seq027 AAAAAAAAAL
seq047 AAAAAAAAAP
seq046 AAAAAAAAAQ
seq041 AAAAAAAAAR
seq040 AAAAAAAAAS
seq051 AAAAAAAAAG
seq012 AAAAAAAAAA
seq013 AAAAAAAAAB
seq003 AAAAAAAAAH
seq002 AAAAAAAAAI
seq038 AAAAAAAAAC
seq015 AAAAAAAAAD
seq009 AAAAAAAAAJ
seq016 AAAAAAAAAU
seq028 AAAAAAAAAT
seq020 AAAAAAAAAK
seq030 AAAAAAAAAE
seq026 AAAAAAAAAM
seq032 AAAAAAAAAF
seq024 AAAAAAAAAN
