ADH2_CAEEL AAAAAAAAAA
MTD_PETCR AAAAAAAAAB
ADH1_BACST AAAAAAAAAC
YAHK_ECOLI AAAAAAAAAD
ADHA_GEOBU AAAAAAAAAE
ADH2_STRCA AAAAAAAAAG
ADH3_YEAST AAAAAAAAAF
MTD_FRAAN AAAAAAAAAI
1o89_A AAAAAAAAAK
CADH_LOLPR AAAAAAAAAJ
FADH_AMYME AAAAAAAAAH
