TRY5_ANOGA AAAAAAAAAB
FA9_CAVPO AAAAAAAAAC
TRY3_RAT AAAAAAAAAD
TRYT_PIG AAAAAAAAAE
KLKB_HUMAN AAAAAAAAAF
KLK3_MOUSE AAAAAAAAAO
PLMN_ERIEU AAAAAAAAAG
KLK1_MOUSE AAAAAAAAAH
1svp_A AAAAAAAAAN
KLK4_MOUSE AAAAAAAAAP
KLK2_RAT AAAAAAAAAK
EL2_BOVIN AAAAAAAAAL
KLK1_HUMAN AAAAAAAAAM
PSS8_MOUSE AAAAAAAAAA
TMS5_MOUSE AAAAAAAAAI
KLK_PIG AAAAAAAAAJ
TRYP_SQUAC AAAAAAAAAQ
