O24646 AAAAAAAAAA
Q69XK6 AAAAAAAAAE
Q0JQA4 AAAAAAAAAC
Q6ZHT8 AAAAAAAAAD
Q9SM50 AAAAAAAAAB
