seq012 AAAAAAAAAA
seq013 AAAAAAAAAB
seq010 AAAAAAAAAC
seq011 AAAAAAAAAD
seq016 AAAAAAAAAE
seq017 AAAAAAAAAF
seq014 AAAAAAAAAG
seq015 AAAAAAAAAH
seq018 AAAAAAAAAI
seq019 AAAAAAAAAJ
seq008 AAAAAAAAAK
seq023 AAAAAAAAAL
seq001 AAAAAAAAAM
seq003 AAAAAAAAAN
seq002 AAAAAAAAAO
seq005 AAAAAAAAAP
seq004 AAAAAAAAAQ
seq007 AAAAAAAAAR
seq006 AAAAAAAAAS
seq009 AAAAAAAAAT
seq022 AAAAAAAAAU
seq021 AAAAAAAAAV
seq020 AAAAAAAAAW
seq025 AAAAAAAAAX
seq024 AAAAAAAAAY
