seq047 AAAAAAAAAA
seq042 AAAAAAAAAB
seq010 AAAAAAAAAD
seq002 AAAAAAAAAE
seq038 AAAAAAAAAF
seq017 AAAAAAAAAG
seq007 AAAAAAAAAH
seq004 AAAAAAAAAN
seq035 AAAAAAAAAI
seq020 AAAAAAAAAJ
seq030 AAAAAAAAAK
seq026 AAAAAAAAAL
seq005 AAAAAAAAAM
seq033 AAAAAAAAAC
