seq012 AAAAAAAAAG
seq019 AAAAAAAAAQ
seq030 AAAAAAAAAR
seq015 AAAAAAAAAM
seq009 AAAAAAAAAN
seq026 AAAAAAAAAS
seq001 AAAAAAAAAA
seq013 AAAAAAAAAH
seq003 AAAAAAAAAI
seq011 AAAAAAAAAJ
seq016 AAAAAAAAAK
seq002 AAAAAAAAAL
seq006 AAAAAAAAAE
seq023 AAAAAAAAAC
seq005 AAAAAAAAAO
seq021 AAAAAAAAAF
seq020 AAAAAAAAAB
seq027 AAAAAAAAAD
seq018 AAAAAAAAAP
seq032 AAAAAAAAAT
seq024 AAAAAAAAAU
