Q4PLY2 AAAAAAAAAA
Q49BM2 AAAAAAAAAB
Q7QKG5 AAAAAAAAAC
Q1HPP1 AAAAAAAAAD
Q4RHZ0 AAAAAAAAAE
P05205 AAAAAAAAAF
Q49BM1 AAAAAAAAAG
