seq020 AAAAAAAAAM
seq008 AAAAAAAAAL
seq015 AAAAAAAAAJ
seq010 AAAAAAAAAF
seq013 AAAAAAAAAE
seq003 AAAAAAAAAC
seq011 AAAAAAAAAG
seq005 AAAAAAAAAH
seq017 AAAAAAAAAI
seq006 AAAAAAAAAB
seq009 AAAAAAAAAK
seq022 AAAAAAAAAD
seq019 AAAAAAAAAA
seq026 AAAAAAAAAN
seq025 AAAAAAAAAO
seq004 AAAAAAAAAP
