TYSY_WIGBR AAAAAAAAAA
TYSY_CLOAB AAAAAAAAAB
DCHM_BPT2 AAAAAAAAAC
TYSY_OCEIH AAAAAAAAAQ
TYSY_LACCA AAAAAAAAAE
TYSY_BPT4 AAAAAAAAAF
TYSY_FUSNN AAAAAAAAAG
TYSY_STRP3 AAAAAAAAAJ
TYSY_LACLA AAAAAAAAAI
TYSY_CAUCR AAAAAAAAAH
1b02_A AAAAAAAAAK
TYSA_BACAM AAAAAAAAAL
1tis_ AAAAAAAAAM
TYSY_LACPL AAAAAAAAAN
TYSY_LISIN AAAAAAAAAO
TYSY_BACAN AAAAAAAAAP
1b49_A AAAAAAAAAD
TYSY_STAAM AAAAAAAAAR
