P51174 AAAAAAAAAF
Q9fs88 AAAAAAAAAB
P15651 AAAAAAAAAD
Q8jzn5 AAAAAAAAAE
Q9kje8 AAAAAAAAAA
P41367 AAAAAAAAAM
P45857 AAAAAAAAAC
P52042 AAAAAAAAAH
1ivh_A AAAAAAAAAI
P13711 AAAAAAAAAJ
P49748 AAAAAAAAAK
P11356 AAAAAAAAAL
P76200 AAAAAAAAAG
