seq012 AAAAAAAAAE
seq011 AAAAAAAAAG
seq014 AAAAAAAAAJ
seq001 AAAAAAAAAA
seq013 AAAAAAAAAF
seq003 AAAAAAAAAD
seq002 AAAAAAAAAC
seq005 AAAAAAAAAH
seq004 AAAAAAAAAI
seq007 AAAAAAAAAB
seq006 AAAAAAAAAK
seq009 AAAAAAAAAL
seq008 AAAAAAAAAM
