Q3MHN2 AAAAAAAAAH
P48747 AAAAAAAAAA
A0SEG9 AAAAAAAAAE
Q7SYA0 AAAAAAAAAC
P48770 AAAAAAAAAD
P06683 AAAAAAAAAF
P02748 AAAAAAAAAG
Q62930 AAAAAAAAAB
