seq020 AAAAAAAAAA
seq010 AAAAAAAAAB
seq021 AAAAAAAAAC
seq037 AAAAAAAAAD
seq027 AAAAAAAAAE
seq026 AAAAAAAAAF
seq032 AAAAAAAAAG
