seq079 AAAAAAAAAF
seq103 AAAAAAAAAN
seq027 AAAAAAAAAM
seq125 AAAAAAAAAA
seq041 AAAAAAAAAO
seq130 AAAAAAAAAG
seq006 AAAAAAAAAL
seq077 AAAAAAAAAH
seq115 AAAAAAAAAC
seq002 AAAAAAAAAK
seq112 AAAAAAAAAD
seq046 AAAAAAAAAT
seq060 AAAAAAAAAB
seq081 AAAAAAAAAQ
seq093 AAAAAAAAAI
seq121 AAAAAAAAAP
seq029 AAAAAAAAAJ
seq084 AAAAAAAAAS
seq032 AAAAAAAAAE
seq086 AAAAAAAAAR
