ACSA_MYCBO AAAAAAAAAF
ACSA_PHYBL AAAAAAAAAB
ACSA_CAUCR AAAAAAAAAC
ACSA_SYNEL AAAAAAAAAD
ACSA_CAMJE AAAAAAAAAE
ACS2_PSEPK AAAAAAAAAA
ACSA_HUMAN AAAAAAAAAG
1amu_A AAAAAAAAAH
