Q8XD03 AAAAAAAAAA
1php_ AAAAAAAAAB
Q97BC6 AAAAAAAAAC
1ltk_A AAAAAAAAAD
P08891 AAAAAAAAAE
13pk_A AAAAAAAAAF
Q9PQL2 AAAAAAAAAG
1qpg_ AAAAAAAAAH
P25055 AAAAAAAAAI
