Q91603 AAAAAAAAAA
Q179M8 AAAAAAAAAB
Q96TE0 AAAAAAAAAC
Q9U6R5 AAAAAAAAAD
P49918 AAAAAAAAAE
Q61CE7 AAAAAAAAAF
Q4FK34 AAAAAAAAAG
