seq078 AAAAAAAAAA
seq055 AAAAAAAAAB
seq137 AAAAAAAAAC
seq073 AAAAAAAAAD
seq105 AAAAAAAAAE
seq106 AAAAAAAAAF
seq053 AAAAAAAAAG
seq081 AAAAAAAAAL
seq011 AAAAAAAAAI
seq099 AAAAAAAAAJ
seq015 AAAAAAAAAK
seq144 AAAAAAAAAH
seq036 AAAAAAAAAM
seq042 AAAAAAAAAN
seq121 AAAAAAAAAO
seq004 AAAAAAAAAP
