seq023 AAAAAAAAAA
seq114 AAAAAAAAAB
seq014 AAAAAAAAAC
seq034 AAAAAAAAAD
seq033 AAAAAAAAAE
seq134 AAAAAAAAAF
seq054 AAAAAAAAAG
seq073 AAAAAAAAAH
seq052 AAAAAAAAAI
seq130 AAAAAAAAAJ
seq092 AAAAAAAAAK
seq095 AAAAAAAAAL
seq067 AAAAAAAAAM
seq003 AAAAAAAAAN
seq061 AAAAAAAAAO
seq009 AAAAAAAAAP
seq022 AAAAAAAAAQ
seq025 AAAAAAAAAR
seq128 AAAAAAAAAS
seq044 AAAAAAAAAT
seq123 AAAAAAAAAU
seq107 AAAAAAAAAV
seq080 AAAAAAAAAW
seq085 AAAAAAAAAX
