PUR1_METJA AAAAAAAAAA
PUR1_MYCLE AAAAAAAAAB
1ct9_A AAAAAAAAAC
ASN1_METJA AAAAAAAAAD
ASN1_YEAST AAAAAAAAAE
PUR1_PYRHO AAAAAAAAAF
PUR1_BACSU AAAAAAAAAO
PUR1_PYRAB AAAAAAAAAG
ASN2_METJA AAAAAAAAAH
ASNH_BACSU AAAAAAAAAI
ASNB_BACSU AAAAAAAAAJ
ASNS_CRIGR AAAAAAAAAK
PUR1_STAAM AAAAAAAAAL
PUR1_SYNY3 AAAAAAAAAN
PUR1_PSEAE AAAAAAAAAM
ASNS_MAIZE AAAAAAAAAP
