seq009 AAAAAAAAAA
seq023 AAAAAAAAAB
seq018 AAAAAAAAAC
seq032 AAAAAAAAAD
seq024 AAAAAAAAAE
