GLMS_BRAJA AAAAAAAAAA
GLMS_CAUCR AAAAAAAAAB
PUR1_METJA AAAAAAAAAD
PUR1_MYCLE AAAAAAAAAE
GLMS_RHIME AAAAAAAAAF
ASNH_MYCTU AAAAAAAAAO
ASN1_YEAST AAAAAAAAAG
ASNO_BACSU AAAAAAAAAH
ASN1_LOTJA AAAAAAAAAJ
PUR1_ARCFU AAAAAAAAAI
PUR1_METTH AAAAAAAAAK
GLMS_PSEAE AAAAAAAAAL
ASNB_BACSU AAAAAAAAAM
PUR1_SYNY3 AAAAAAAAAN
PUR1_STAAM AAAAAAAAAC
