NOSZ_PSEFL AAAAAAAAAO
PLAS_SCEOB AAAAAAAAAQ
1j5c_A AAAAAAAAAH
NOSZ_BRUME AAAAAAAAAD
PLAS_SYNP7 AAAAAAAAAE
1aac_ AAAAAAAAAF
1ag6_ AAAAAAAAAU
1b3i_A AAAAAAAAAG
NOSZ_ALCEU AAAAAAAAAI
AZUP_RHILV AAAAAAAAAJ
AZU2_ALCXX AAAAAAAAAK
PLAS_ANASO AAAAAAAAAL
1baw_A AAAAAAAAAM
AZUR_BORPE AAAAAAAAAN
NSZ1_PSEAE AAAAAAAAAA
1cuo_A AAAAAAAAAP
AZUR_METFL AAAAAAAAAC
NOSZ_BRAJA AAAAAAAAAR
1fwx_A AAAAAAAAAS
AZU1_ALCXX AAAAAAAAAT
AZU1_METJ AAAAAAAAAB
