P03129 AAAAAAAAAA
Q6T377 AAAAAAAAAB
P36831 AAAAAAAAAC
P27230 AAAAAAAAAD
P36828 AAAAAAAAAE
Q82006 AAAAAAAAAF
O90724 AAAAAAAAAG
Q17UH7 AAAAAAAAAI
P26557 AAAAAAAAAH
