P24597 AAAAAAAAAA
P03070 AAAAAAAAAB
P04008 AAAAAAAAAC
P24851 AAAAAAAAAD
P03075 AAAAAAAAAE
