Q14526 AAAAAAAAAA
Q70ZY9 AAAAAAAAAB
Q504K0 AAAAAAAAAC
Q9JLZ6 AAAAAAAAAD
A0JMY9 AAAAAAAAAE
Q08CG0 AAAAAAAAAF
HIC1_CHICK AAAAAAAAAG
