Q3I525 AAAAAAAAAJ
P50538 AAAAAAAAAL
P50539 AAAAAAAAAK
Q28CB7 AAAAAAAAAC
Q05195 AAAAAAAAAD
P50541 AAAAAAAAAE
Q0VCC9 AAAAAAAAAF
Q3USD3 AAAAAAAAAI
Q0VH34 AAAAAAAAAH
Q7ZUI9 AAAAAAAAAA
Q6FHW2 AAAAAAAAAB
Q66II4 AAAAAAAAAG
