seq049 AAAAAAAAAA
seq059 AAAAAAAAAB
seq041 AAAAAAAAAC
seq040 AAAAAAAAAD
seq012 AAAAAAAAAE
seq006 AAAAAAAAAF
seq030 AAAAAAAAAG
seq033 AAAAAAAAAH
