seq216 AAAAAAAAAA
seq200 AAAAAAAAAB
seq059 AAAAAAAAAC
seq122 AAAAAAAAAD
seq010 AAAAAAAAAE
seq087 AAAAAAAAAL
seq178 AAAAAAAAAH
seq152 AAAAAAAAAG
seq018 AAAAAAAAAI
seq140 AAAAAAAAAJ
seq026 AAAAAAAAAK
seq119 AAAAAAAAAF
seq033 AAAAAAAAAM
