seq046 AAAAAAAAAA
seq041 AAAAAAAAAB
seq050 AAAAAAAAAC
seq013 AAAAAAAAAD
seq028 AAAAAAAAAE
seq009 AAAAAAAAAF
seq027 AAAAAAAAAG
seq034 AAAAAAAAAH
