seq019 AAAAAAAAAP
seq025 AAAAAAAAAS
seq010 AAAAAAAAAG
seq022 AAAAAAAAAN
seq012 AAAAAAAAAE
seq013 AAAAAAAAAF
seq003 AAAAAAAAAD
seq011 AAAAAAAAAH
seq005 AAAAAAAAAI
seq017 AAAAAAAAAJ
seq014 AAAAAAAAAK
seq006 AAAAAAAAAL
seq009 AAAAAAAAAM
seq008 AAAAAAAAAC
seq028 AAAAAAAAAO
seq020 AAAAAAAAAA
seq035 AAAAAAAAAQ
seq026 AAAAAAAAAR
seq032 AAAAAAAAAB
seq033 AAAAAAAAAT
