seq053 AAAAAAAAAK
seq012 AAAAAAAAAB
seq039 AAAAAAAAAC
seq018 AAAAAAAAAD
seq036 AAAAAAAAAE
seq032 AAAAAAAAAF
seq079 AAAAAAAAAG
seq070 AAAAAAAAAH
seq054 AAAAAAAAAI
seq074 AAAAAAAAAJ
seq075 AAAAAAAAAA
seq050 AAAAAAAAAL
seq098 AAAAAAAAAM
seq094 AAAAAAAAAN
seq001 AAAAAAAAAO
seq065 AAAAAAAAAP
seq004 AAAAAAAAAQ
seq022 AAAAAAAAAR
seq021 AAAAAAAAAS
seq049 AAAAAAAAAT
seq101 AAAAAAAAAU
seq046 AAAAAAAAAV
seq089 AAAAAAAAAW
