seq325 AAAAAAAAAA
seq518 AAAAAAAAAB
seq465 AAAAAAAAAC
seq656 AAAAAAAAAD
seq416 AAAAAAAAAE
seq116 AAAAAAAAAF
seq401 AAAAAAAAAG
seq023 AAAAAAAAAH
