seq108 AAAAAAAAAA
seq057 AAAAAAAAAB
seq125 AAAAAAAAAC
seq043 AAAAAAAAAD
seq089 AAAAAAAAAE
seq064 AAAAAAAAAF
seq099 AAAAAAAAAG
seq061 AAAAAAAAAH
seq021 AAAAAAAAAI
seq084 AAAAAAAAAJ
