seq079 AAAAAAAAAA
seq072 AAAAAAAAAB
seq006 AAAAAAAAAL
seq074 AAAAAAAAAD
seq040 AAAAAAAAAE
seq043 AAAAAAAAAF
seq075 AAAAAAAAAG
seq067 AAAAAAAAAH
seq002 AAAAAAAAAI
seq050 AAAAAAAAAJ
seq007 AAAAAAAAAK
seq060 AAAAAAAAAC
seq023 AAAAAAAAAM
seq036 AAAAAAAAAN
seq042 AAAAAAAAAO
seq085 AAAAAAAAAP
seq031 AAAAAAAAAQ
seq025 AAAAAAAAAR
seq039 AAAAAAAAAS
