CBPX_ORYSA AAAAAAAAAH
YSS2_CAEEL AAAAAAAAAB
CBPX_ARATH AAAAAAAAAC
YBY9_YEAST AAAAAAAAAD
CP23_HORVU AAAAAAAAAE
CBPY_SCHPO AAAAAAAAAF
CBP3_HORVU AAAAAAAAAG
CBPY_PICPA AAAAAAAAAA
CBPY_CANAL AAAAAAAAAI
YUA6_CAEEL AAAAAAAAAJ
1ysc_ AAAAAAAAAK
CP22_HORVU AAAAAAAAAL
