seq013 AAAAAAAAAA
seq179 AAAAAAAAAB
seq152 AAAAAAAAAC
seq150 AAAAAAAAAD
seq034 AAAAAAAAAE
seq078 AAAAAAAAAF
seq138 AAAAAAAAAG
seq059 AAAAAAAAAH
seq054 AAAAAAAAAI
seq051 AAAAAAAAAJ
seq275 AAAAAAAAAK
seq255 AAAAAAAAAL
seq198 AAAAAAAAAM
seq234 AAAAAAAAAN
seq005 AAAAAAAAAO
seq006 AAAAAAAAAP
seq146 AAAAAAAAAQ
seq082 AAAAAAAAAR
seq107 AAAAAAAAAS
seq182 AAAAAAAAAT
seq186 AAAAAAAAAU
seq222 AAAAAAAAAV
seq225 AAAAAAAAAW
seq087 AAAAAAAAAX
