1mrp_ AAAAAAAAAA
SUBI_SYNY3 AAAAAAAAAN
1pot_ AAAAAAAAAB
POT2_HAEIN AAAAAAAAAC
FBPA_SERMA AAAAAAAAAD
MODA_AZOVI AAAAAAAAAE
CYSP_ECOLI AAAAAAAAAK
FBPA_NEIMA AAAAAAAAAH
SUBI_SYNP7 AAAAAAAAAI
POT1_HAEIN AAAAAAAAAJ
1sbp_ AAAAAAAAAG
1atg_ AAAAAAAAAL
POTF_ECOLI AAAAAAAAAM
1wod_ AAAAAAAAAF
MODA_RHOCA AAAAAAAAAO
