seq012 AAAAAAAAAF
seq011 AAAAAAAAAI
seq014 AAAAAAAAAL
seq015 AAAAAAAAAM
seq010 AAAAAAAAAH
seq001 AAAAAAAAAA
seq013 AAAAAAAAAG
seq003 AAAAAAAAAE
seq002 AAAAAAAAAC
seq005 AAAAAAAAAJ
seq004 AAAAAAAAAK
seq007 AAAAAAAAAB
seq006 AAAAAAAAAD
seq009 AAAAAAAAAN
seq008 AAAAAAAAAO
