TPIS_WOLSU AAAAAAAAAA
TPIS_BIFLO AAAAAAAAAE
TPIS_LATCH AAAAAAAAAD
TPIS_CHLCV AAAAAAAAAC
TPIS_TROW8 AAAAAAAAAJ
1lyx_A AAAAAAAAAF
TPIS_BACAA AAAAAAAAAG
1amk_ AAAAAAAAAH
TPIS_MYCGE AAAAAAAAAI
TPIS_RHIET AAAAAAAAAB
TPIS_UREPA AAAAAAAAAK
TPI2_RHILO AAAAAAAAAL
TPI2_LISIN AAAAAAAAAM
TPI1_BRUME AAAAAAAAAN
TPIS_FRATU AAAAAAAAAO
