seq171 AAAAAAAAAA
seq354 AAAAAAAAAB
seq238 AAAAAAAAAC
seq114 AAAAAAAAAD
seq261 AAAAAAAAAE
seq255 AAAAAAAAAF
seq367 AAAAAAAAAG
seq293 AAAAAAAAAI
seq284 AAAAAAAAAH
