THCD_RHOER AAAAAAAAAA
TRXB_STRCL AAAAAAAAAB
TRXB_BUCBP AAAAAAAAAC
GSHR_ANASP AAAAAAAAAD
GSHC_SPIOL AAAAAAAAAE
TRXB_NEUCR AAAAAAAAAF
TRXB_TREPA AAAAAAAAAG
GSHR_PSEAE AAAAAAAAAH
TRXB_CHLPN AAAAAAAAAI
DLDH_HALVO AAAAAAAAAJ
AHPF_ECOLI AAAAAAAAAK
TRXB_BUCAP AAAAAAAAAL
1d7y_A AAAAAAAAAM
1nhp_ AAAAAAAAAN
AHPF_STAAM AAAAAAAAAO
YDGE_SCHPO AAAAAAAAAP
TRXB_MYCPN AAAAAAAAAQ
GSHR_ORYSA AAAAAAAAAR
DLD1_BACST AAAAAAAAAS
DLDH_CHLMU AAAAAAAAAT
TRXB_CHLMU AAAAAAAAAU
TRXB_METJA AAAAAAAAAV
