APA1_BRARE_3 AAAAAAAAAA
APA1_SALTR_2 AAAAAAAAAB
APA1_SALTR_1 AAAAAAAAAC
APA1_SALTR_4 AAAAAAAAAD
AP12_ONCMY_2 AAAAAAAAAE
AP12_ONCMY_3 AAAAAAAAAF
AP11_ONCMY_3 AAAAAAAAAG
AP12_ONCMY_8 AAAAAAAAAH
