KTHY_MYCPN AAAAAAAAAA
KTHY_PYRHO AAAAAAAAAB
1bif_ AAAAAAAAAC
KTHY_HALN1 AAAAAAAAAD
KTHY_CAMJE AAAAAAAAAE
1kgd_A AAAAAAAAAF
KTHY_LACPL AAAAAAAAAG
KTHY_NEIMA AAAAAAAAAH
KTHY_STRPN AAAAAAAAAI
KTHY_XYLFA AAAAAAAAAJ
KTHY_LACLA AAAAAAAAAK
