seq049 AAAAAAAAAA
seq045 AAAAAAAAAB
seq053 AAAAAAAAAC
seq067 AAAAAAAAAD
seq038 AAAAAAAAAE
seq004 AAAAAAAAAF
seq061 AAAAAAAAAG
seq035 AAAAAAAAAH
seq019 AAAAAAAAAI
seq030 AAAAAAAAAJ
seq032 AAAAAAAAAK
