NEPU_BACST AAAAAAAAAB
AMY1_SACFI AAAAAAAAAC
YQ29_SCHPO AAAAAAAAAL
AMY1_SCHPO AAAAAAAAAD
1pam_A AAAAAAAAAE
AMY3_SCHPO AAAAAAAAAF
AMY_CLOAB AAAAAAAAAG
AMYR_DROSU AAAAAAAAAM
1jdc_ AAAAAAAAAI
AMY_STRTL AAAAAAAAAJ
AMY_THECU AAAAAAAAAK
AMY4_SCHPO AAAAAAAAAA
AMYB_PAEPO AAAAAAAAAH
AMY2_DEBOC AAAAAAAAAN
