SYQ_HAEIN AAAAAAAAAA
SYQ_PSEAE AAAAAAAAAE
SYQ_DEIRA AAAAAAAAAC
SYQ_BUCAI AAAAAAAAAD
SYQ_NEIMA AAAAAAAAAB
SYEC_YEAST AAAAAAAAAF
1euq_A AAAAAAAAAG
SYQ_BUCAP AAAAAAAAAH
SYQ_RALSO AAAAAAAAAI
SYEP_DROME AAAAAAAAAJ
SYEP_HUMAN AAAAAAAAAK
SYQ_CLOPE AAAAAAAAAL
SYQ_BUCBP AAAAAAAAAM
SYQ_LUPLU AAAAAAAAAN
SYQ_XANAC AAAAAAAAAO
SYQ_XYLFA AAAAAAAAAP
SYQ_DROME AAAAAAAAAQ
