seq012 AAAAAAAAAA
seq016 AAAAAAAAAB
seq017 AAAAAAAAAC
seq014 AAAAAAAAAD
seq015 AAAAAAAAAE
seq018 AAAAAAAAAF
seq037 AAAAAAAAAK
seq030 AAAAAAAAAH
seq031 AAAAAAAAAI
seq033 AAAAAAAAAJ
seq019 AAAAAAAAAG
seq008 AAAAAAAAAL
seq002 AAAAAAAAAM
seq007 AAAAAAAAAN
seq023 AAAAAAAAAO
seq022 AAAAAAAAAP
seq026 AAAAAAAAAQ
seq024 AAAAAAAAAR
seq044 AAAAAAAAAS
seq046 AAAAAAAAAT
seq041 AAAAAAAAAU
seq043 AAAAAAAAAV
seq039 AAAAAAAAAW
