seq012 AAAAAAAAAD
seq002 AAAAAAAAAI
seq010 AAAAAAAAAE
seq001 AAAAAAAAAA
seq003 AAAAAAAAAC
seq011 AAAAAAAAAF
seq005 AAAAAAAAAG
seq004 AAAAAAAAAH
seq007 AAAAAAAAAB
seq006 AAAAAAAAAJ
seq009 AAAAAAAAAK
seq008 AAAAAAAAAL
