Q95YJ1 AAAAAAAAAA
Q9NI63 AAAAAAAAAB
Q177G3 AAAAAAAAAC
O14731 AAAAAAAAAD
Q91618 AAAAAAAAAE
