SYH_CLOAB AAAAAAAAAA
SYP_BORBU AAAAAAAAAC
SYP_CLOST AAAAAAAAAF
1h4q_A AAAAAAAAAE
SYP_MYCGE AAAAAAAAAI
SYP_METTH AAAAAAAAAG
SYP_MYCLE AAAAAAAAAH
1nj8_A AAAAAAAAAD
SYT_THETN AAAAAAAAAJ
SYP_ARCFU AAAAAAAAAK
SYSM_BOVIN AAAAAAAAAL
YHI0_YEAST AAAAAAAAAM
SYP_MYCPN AAAAAAAAAQ
1qe0_A AAAAAAAAAN
SYTM_YEAST AAAAAAAAAO
SYS_AQUAE AAAAAAAAAP
1ser_A AAAAAAAAAB
