seq048 AAAAAAAAAA
seq056 AAAAAAAAAB
seq057 AAAAAAAAAC
seq047 AAAAAAAAAD
seq051 AAAAAAAAAE
seq012 AAAAAAAAAF
seq011 AAAAAAAAAG
seq007 AAAAAAAAAH
seq060 AAAAAAAAAI
seq023 AAAAAAAAAJ
seq018 AAAAAAAAAK
seq037 AAAAAAAAAL
seq030 AAAAAAAAAM
seq028 AAAAAAAAAN
