Q1RLD1 AAAAAAAAAA
Q15637 AAAAAAAAAB
Q2GXG9 AAAAAAAAAC
Q628E1 AAAAAAAAAD
Q5KII2 AAAAAAAAAE
Q0IFQ3 AAAAAAAAAF
