SYR_LISIN AAAAAAAAAA
SYR_PYRAB AAAAAAAAAB
SYR_GLOVI AAAAAAAAAC
SYR_HELPJ AAAAAAAAAD
SYR_LEPIN AAAAAAAAAE
SYR_UREPA AAAAAAAAAF
1iq0_A AAAAAAAAAG
SYR_RHILO AAAAAAAAAH
SYR_MYCSM AAAAAAAAAI
SYR_MYCGA AAAAAAAAAJ
SYR_XYLFA AAAAAAAAAK
