DHS4_BOVIN AAAAAAAAAB
1o5i_A AAAAAAAAAC
FABG_BUCBP AAAAAAAAAD
YHDF_BACSU AAAAAAAAAK
DHB8_HUMAN AAAAAAAAAE
TRNH_DATST AAAAAAAAAF
FABG_RICPR AAAAAAAAAG
YWFD_BACSU AAAAAAAAAH
DHG2_BACSU AAAAAAAAAI
PHBB_CHRVI AAAAAAAAAL
FABG_BUCAP AAAAAAAAAA
SOU2_CANAL AAAAAAAAAJ
PHAB_ACISP AAAAAAAAAM
Y4VI_RHISN AAAAAAAAAN
