Q6CA20 AAAAAAAAAA
P33767 AAAAAAAAAB
Q0CIB4 AAAAAAAAAC
Q6BVZ6 AAAAAAAAAD
O59866 AAAAAAAAAE
Q55L11 AAAAAAAAAF
Q23AP5 AAAAAAAAAG
Q4P4G9 AAAAAAAAAH
