seq012 AAAAAAAAAA
seq009 AAAAAAAAAH
seq010 AAAAAAAAAC
seq002 AAAAAAAAAD
seq016 AAAAAAAAAE
seq007 AAAAAAAAAF
seq015 AAAAAAAAAG
seq034 AAAAAAAAAB
seq022 AAAAAAAAAI
seq028 AAAAAAAAAJ
seq019 AAAAAAAAAK
seq030 AAAAAAAAAL
seq036 AAAAAAAAAM
seq033 AAAAAAAAAN
