Q1LXU3 AAAAAAAAAA
Q5BBZ9 AAAAAAAAAI
A1CTG3 AAAAAAAAAC
Q8WU79 AAAAAAAAAD
Q1E858 AAAAAAAAAE
Q91VZ6 AAAAAAAAAF
Q0U7H0 AAAAAAAAAG
Q4HZV9 AAAAAAAAAH
Q6C1Q7 AAAAAAAAAB
Q7RZD7 AAAAAAAAAJ
