SYSC_CANAL AAAAAAAAAA
SYS_BACHD AAAAAAAAAF
SYS_RICCN AAAAAAAAAE
SYS_OCEIH AAAAAAAAAD
SYS_SULSO AAAAAAAAAG
SYS_SHEON AAAAAAAAAH
SYS_VIBCH AAAAAAAAAI
SYS_HELPJ AAAAAAAAAJ
SYS_CHLMU AAAAAAAAAK
SYS_TREPA AAAAAAAAAL
SYS_METAC AAAAAAAAAN
SYS_CAUCR AAAAAAAAAM
SYS_LACLA AAAAAAAAAC
SYS_FUSNN AAAAAAAAAB
