seq044 AAAAAAAAAA
seq046 AAAAAAAAAB
seq013 AAAAAAAAAC
seq028 AAAAAAAAAD
seq016 AAAAAAAAAE
seq017 AAAAAAAAAF
seq022 AAAAAAAAAG
seq018 AAAAAAAAAH
seq032 AAAAAAAAAI
