Q6RUW4 AAAAAAAAAA
Q4F782 AAAAAAAAAB
Q5ZHY7 AAAAAAAAAC
Q640K0 AAAAAAAAAD
Q8WSQ5 AAAAAAAAAE
MPIP2_HUMAN__2 AAAAAAAAAF
P48964 AAAAAAAAAH
P30307 AAAAAAAAAG
P30311 AAAAAAAAAI
