seq012 AAAAAAAAAG
seq011 AAAAAAAAAJ
seq014 AAAAAAAAAM
seq015 AAAAAAAAAN
seq010 AAAAAAAAAI
seq001 AAAAAAAAAA
seq013 AAAAAAAAAH
seq003 AAAAAAAAAF
seq002 AAAAAAAAAC
seq016 AAAAAAAAAK
seq004 AAAAAAAAAL
seq007 AAAAAAAAAB
seq006 AAAAAAAAAE
seq009 AAAAAAAAAO
seq008 AAAAAAAAAD
seq005 AAAAAAAAAP
