Q1RM43 AAAAAAAAAA
A0CHN0 AAAAAAAAAB
Q5YER4 AAAAAAAAAC
Q5EUD0 AAAAAAAAAD
Q8LAM5 AAAAAAAAAE
P09103 AAAAAAAAAF
Q9SBN2 AAAAAAAAAG
