ENO_HOMGA AAAAAAAAAA
ENO_MYCPU AAAAAAAAAB
1fhu_A AAAAAAAAAC
ENO_DEIRA AAAAAAAAAG
ENO_BACHD AAAAAAAAAE
ENO_CHLCV AAAAAAAAAF
ENO_AERHY AAAAAAAAAD
