AHPF_ECOLI AAAAAAAAAA
TRXB_MYCLE AAAAAAAAAB
TRXB_BUCBP AAAAAAAAAC
TRB1_ARATH AAAAAAAAAD
TRXB_CHLPN AAAAAAAAAE
DLDH_ZYMMO AAAAAAAAAF
TRXB_BUCAP AAAAAAAAAG
DHNA_BACSP AAAAAAAAAH
TRXB_BACSU AAAAAAAAAI
TRXB_SCHPO AAAAAAAAAJ
DLDH_PEA AAAAAAAAAK
TRXB_UREPA AAAAAAAAAL
DLDH_YEAST AAAAAAAAAM
DLDH_TRYBB AAAAAAAAAN
DLD1_BACSU AAAAAAAAAO
1d7y_A AAAAAAAAAP
TRXB_CHLMU AAAAAAAAAQ
TRXB_METJA AAAAAAAAAR
DLDH_MYCPN AAAAAAAAAS
