seq049 AAAAAAAAAA
seq135 AAAAAAAAAB
seq127 AAAAAAAAAC
seq054 AAAAAAAAAD
seq125 AAAAAAAAAE
seq041 AAAAAAAAAF
seq115 AAAAAAAAAI
seq088 AAAAAAAAAH
seq065 AAAAAAAAAG
seq016 AAAAAAAAAJ
seq111 AAAAAAAAAK
seq071 AAAAAAAAAL
