seq116 AAAAAAAAAC
seq086 AAAAAAAAAE
seq131 AAAAAAAAAA
seq141 AAAAAAAAAD
seq121 AAAAAAAAAB
