seq037 AAAAAAAAAK
seq014 AAAAAAAAAI
seq056 AAAAAAAAAC
seq044 AAAAAAAAAD
seq040 AAAAAAAAAE
seq001 AAAAAAAAAF
seq029 AAAAAAAAAG
seq011 AAAAAAAAAH
seq007 AAAAAAAAAB
seq015 AAAAAAAAAJ
seq019 AAAAAAAAAA
seq027 AAAAAAAAAL
