CPB9_MOUSE AAAAAAAAAA
CYPD_BACSU AAAAAAAAAB
CPCV_CAPAE AAAAAAAAAC
CPXH_STRGR AAAAAAAAAD
CPJ2_HUMAN AAAAAAAAAE
