seq045 AAAAAAAAAA
seq041 AAAAAAAAAB
seq042 AAAAAAAAAC
seq002 AAAAAAAAAD
seq039 AAAAAAAAAE
seq006 AAAAAAAAAF
seq008 AAAAAAAAAG
seq024 AAAAAAAAAH
