1fhu_A AAAAAAAAAA
1kcz_A AAAAAAAAAB
1rvk_A AAAAAAAAAC
4enl_ AAAAAAAAAD
2mnr_ AAAAAAAAAE
1muc_A AAAAAAAAAF
1bqg_ AAAAAAAAAG
1jpd_X AAAAAAAAAH
