Q55PZ1 AAAAAAAAAA
O14757 AAAAAAAAAB
Q59DY7 AAAAAAAAAC
P34208 AAAAAAAAAE
Q2ULE5 AAAAAAAAAD
