seq071 AAAAAAAAAA
seq074 AAAAAAAAAB
seq076 AAAAAAAAAC
seq042 AAAAAAAAAD
seq012 AAAAAAAAAE
seq003 AAAAAAAAAF
seq005 AAAAAAAAAG
seq050 AAAAAAAAAH
seq060 AAAAAAAAAI
seq034 AAAAAAAAAJ
seq021 AAAAAAAAAK
seq019 AAAAAAAAAL
seq027 AAAAAAAAAM
seq026 AAAAAAAAAN
seq017 AAAAAAAAAO
