seq037 AAAAAAAAAP
seq019 AAAAAAAAAA
seq049 AAAAAAAAAB
seq045 AAAAAAAAAD
seq052 AAAAAAAAAG
seq006 AAAAAAAAAM
seq041 AAAAAAAAAE
seq051 AAAAAAAAAC
seq012 AAAAAAAAAI
seq011 AAAAAAAAAJ
seq005 AAAAAAAAAK
seq004 AAAAAAAAAL
seq042 AAAAAAAAAH
seq023 AAAAAAAAAN
seq028 AAAAAAAAAO
seq020 AAAAAAAAAF
seq031 AAAAAAAAAQ
seq024 AAAAAAAAAR
