1jdc_ AAAAAAAAAI
NEPU_BACST AAAAAAAAAB
AMY_BACME AAAAAAAAAF
AMY1_DEBOC AAAAAAAAAD
1bvz_A AAAAAAAAAE
1pam_A AAAAAAAAAG
AMY_STRLI AAAAAAAAAP
AMYA_ASPAW AAAAAAAAAH
MALT_CANAL AAAAAAAAAA
MAL2_DROME AAAAAAAAAJ
AMY2_SCHPO AAAAAAAAAK
MAL1_APIME AAAAAAAAAL
TREZ_BREHE AAAAAAAAAM
1eh9_A AAAAAAAAAN
CDG1_PAEMA AAAAAAAAAO
YQ29_SCHPO AAAAAAAAAC
