seq079 AAAAAAAAAA
seq046 AAAAAAAAAB
seq051 AAAAAAAAAC
seq065 AAAAAAAAAD
seq063 AAAAAAAAAE
seq014 AAAAAAAAAF
seq021 AAAAAAAAAG
seq037 AAAAAAAAAH
seq031 AAAAAAAAAI
