Q9GR90 AAAAAAAAAA
P49257 AAAAAAAAAB
Q5M909 AAAAAAAAAC
Q55AC7 AAAAAAAAAD
Q7Q7B2 AAAAAAAAAE
P90913 AAAAAAAAAF
