GLGB_ERWCH AAAAAAAAAA
1bag_ AAAAAAAAAB
GLB2_STRCO AAAAAAAAAC
GLGB_BACCL AAAAAAAAAD
GLGB_COREF AAAAAAAAAE
GLB2_CLOPE AAAAAAAAAF
GLGB_CHLPN AAAAAAAAAG
GLGB_NITEU AAAAAAAAAH
GLGB_SYNP7 AAAAAAAAAI
GLGB_HAEIN AAAAAAAAAJ
