O77290 AAAAAAAAAA
O00203 AAAAAAAAAB
Q52KY5 AAAAAAAAAC
Q60L76 AAAAAAAAAD
Q13367 AAAAAAAAAE
