seq078 AAAAAAAAAA
seq049 AAAAAAAAAB
seq058 AAAAAAAAAC
seq045 AAAAAAAAAD
seq046 AAAAAAAAAG
seq039 AAAAAAAAAT
seq077 AAAAAAAAAH
seq066 AAAAAAAAAI
seq015 AAAAAAAAAR
seq028 AAAAAAAAAJ
seq017 AAAAAAAAAF
seq061 AAAAAAAAAL
seq006 AAAAAAAAAM
seq034 AAAAAAAAAN
seq008 AAAAAAAAAO
seq036 AAAAAAAAAP
seq033 AAAAAAAAAQ
seq030 AAAAAAAAAE
seq069 AAAAAAAAAS
seq004 AAAAAAAAAK
