GLGB_STRAW AAAAAAAAAA
GLGB_BUTFI AAAAAAAAAJ
CDAS_THEET AAAAAAAAAB
GLGB_PSEPK AAAAAAAAAC
GLGB_SHEON AAAAAAAAAD
AMY_ALTHA AAAAAAAAAE
AMY_STRTL AAAAAAAAAF
GLGB_YERPE AAAAAAAAAH
AMY2_ECOLI AAAAAAAAAI
GLGB_FUSNN AAAAAAAAAG
CDG1_PAEMA AAAAAAAAAK
