seq108 AAAAAAAAAA
seq138 AAAAAAAAAB
seq128 AAAAAAAAAC
seq199 AAAAAAAAAL
seq137 AAAAAAAAAD
seq187 AAAAAAAAAM
seq012 AAAAAAAAAH
seq252 AAAAAAAAAI
seq114 AAAAAAAAAG
seq038 AAAAAAAAAK
seq142 AAAAAAAAAR
seq064 AAAAAAAAAJ
seq248 AAAAAAAAAE
seq009 AAAAAAAAAN
seq145 AAAAAAAAAF
seq020 AAAAAAAAAP
seq193 AAAAAAAAAQ
seq175 AAAAAAAAAO
seq235 AAAAAAAAAS
