PO3A_XENLA AAAAAAAAAA
PO51_BOVIN AAAAAAAAAB
POU2_BRARE AAAAAAAAAC
ZP47_BRARE AAAAAAAAAD
BR31_BRARE AAAAAAAAAE
HM16_XENLA AAAAAAAAAF
PDM2_DROME AAAAAAAAAG
SGF3_BOMMO AAAAAAAAAH
PO33_HUMAN AAAAAAAAAI
PO31_HUMAN AAAAAAAAAJ
PO32_HUMAN AAAAAAAAAK
PO34_HUMAN AAAAAAAAAL
CF1A_DROME AAAAAAAAAM
SPM1_HUMAN AAAAAAAAAN
PO61_HUMAN AAAAAAAAAO
PDM1_DROME AAAAAAAAAP
PO21_CHICK AAAAAAAAAQ
