seq140 AAAAAAAAAL
seq073 AAAAAAAAAD
seq050 AAAAAAAAAE
seq237 AAAAAAAAAM
seq001 AAAAAAAAAJ
seq183 AAAAAAAAAN
seq184 AAAAAAAAAO
seq015 AAAAAAAAAA
seq197 AAAAAAAAAG
seq035 AAAAAAAAAB
seq036 AAAAAAAAAC
seq236 AAAAAAAAAF
seq168 AAAAAAAAAK
seq191 AAAAAAAAAH
seq095 AAAAAAAAAI
