seq001 AAAAAAAAAD
seq015 AAAAAAAAAH
seq036 AAAAAAAAAJ
seq026 AAAAAAAAAM
seq012 AAAAAAAAAA
seq013 AAAAAAAAAE
seq038 AAAAAAAAAF
seq006 AAAAAAAAAB
seq008 AAAAAAAAAI
seq018 AAAAAAAAAG
seq037 AAAAAAAAAK
seq035 AAAAAAAAAL
seq031 AAAAAAAAAC
seq024 AAAAAAAAAN
