Q5ZKD8 AAAAAAAAAA
Q4RXT3 AAAAAAAAAB
P51784 AAAAAAAAAC
Q2NLB3 AAAAAAAAAD
Q4RWH0 AAAAAAAAAE
UBP15_MOUSE AAAAAAAAAF
Q13107 AAAAAAAAAG
