DPO1_HELPJ AAAAAAAAAA
DPO1_MYCLE AAAAAAAAAB
DPO1_ANATH AAAAAAAAAD
DPO1_RHILE AAAAAAAAAJ
1bgx_T AAAAAAAAAE
DPO1_SYNY3 AAAAAAAAAF
DPO1_RICFE AAAAAAAAAG
DPO1_LACLA AAAAAAAAAH
DPO1_TREPA AAAAAAAAAC
DPO1_BORBU AAAAAAAAAI
