1mo9_A AAAAAAAAAA
1gv4_A AAAAAAAAAB
1djn_A AAAAAAAAAC
1fcd_A AAAAAAAAAD
1nhp_ AAAAAAAAAG
1d7y_A AAAAAAAAAF
1lvl_ AAAAAAAAAE
1cl0_A AAAAAAAAAH
