seq047 AAAAAAAAAO
seq020 AAAAAAAAAN
seq054 AAAAAAAAAT
seq056 AAAAAAAAAF
seq072 AAAAAAAAAG
seq073 AAAAAAAAAH
seq041 AAAAAAAAAP
seq029 AAAAAAAAAJ
seq050 AAAAAAAAAI
seq042 AAAAAAAAAR
seq043 AAAAAAAAAQ
seq010 AAAAAAAAAA
seq002 AAAAAAAAAK
seq017 AAAAAAAAAB
seq064 AAAAAAAAAS
seq008 AAAAAAAAAL
seq018 AAAAAAAAAC
seq019 AAAAAAAAAD
seq030 AAAAAAAAAE
seq021 AAAAAAAAAM
