GTA1_BOVIN AAAAAAAAAA
GTS3_CAEEL AAAAAAAAAB
GT26_SCHMA AAAAAAAAAC
1g6w_A AAAAAAAAAD
GTP2_BUFBU AAAAAAAAAE
GTS1_ASCSU AAAAAAAAAF
GTA1_ANTST AAAAAAAAAG
GTP_DIRIM AAAAAAAAAH
GTC1_RAT AAAAAAAAAI
GTA3_CHICK AAAAAAAAAJ
GTA1_MOUSE AAAAAAAAAK
1nhy_A AAAAAAAAAL
