seq048 AAAAAAAAAB
seq045 AAAAAAAAAC
seq055 AAAAAAAAAD
seq041 AAAAAAAAAE
seq010 AAAAAAAAAI
seq042 AAAAAAAAAG
seq023 AAAAAAAAAO
seq056 AAAAAAAAAH
seq029 AAAAAAAAAF
seq011 AAAAAAAAAJ
seq038 AAAAAAAAAK
seq004 AAAAAAAAAL
seq014 AAAAAAAAAM
seq006 AAAAAAAAAN
seq034 AAAAAAAAAA
seq036 AAAAAAAAAP
seq020 AAAAAAAAAQ
seq030 AAAAAAAAAR
seq018 AAAAAAAAAS
