Q9lpm9 AAAAAAAAAA
Q9m439 AAAAAAAAAB
Q9fya6 AAAAAAAAAC
Q99w55 AAAAAAAAAD
O35854 AAAAAAAAAE
O32954 AAAAAAAAAF
P54689 AAAAAAAAAK
P54690 AAAAAAAAAH
P47176 AAAAAAAAAI
P54687 AAAAAAAAAJ
P39576 AAAAAAAAAG
O26004 AAAAAAAAAL
1et0_A AAAAAAAAAM
