seq037 AAAAAAAAAI
seq046 AAAAAAAAAB
seq042 AAAAAAAAAC
seq038 AAAAAAAAAD
seq017 AAAAAAAAAE
seq009 AAAAAAAAAF
seq035 AAAAAAAAAG
seq018 AAAAAAAAAH
seq019 AAAAAAAAAA
