DPO1_MYCLE AAAAAAAAAA
DPO1_ANATH AAAAAAAAAB
DPO1_RHILE AAAAAAAAAC
EX53_BUCBP AAAAAAAAAD
1exn_A AAAAAAAAAE
EX53_UREPA AAAAAAAAAF
