Q9Z0R6_1 AAAAAAAAAA
Q9Z0R6_2 AAAAAAAAAB
O42287_2 AAAAAAAAAC
O42287_1 AAAAAAAAAD
o95216_1 AAAAAAAAAE
O61618_1 AAAAAAAAAF
O61618_2 AAAAAAAAAG
o95216_2 AAAAAAAAAH
Q9U2T9_2 AAAAAAAAAI
Q9U2T9_1 AAAAAAAAAJ
Q9Z0R4_2 AAAAAAAAAK
Q9Z0R4_1 AAAAAAAAAL
