2hsd_A AAAAAAAAAA
1dhr_ AAAAAAAAAB
1a9y_ AAAAAAAAAC
1n5d_A AAAAAAAAAD
1pwx_A AAAAAAAAAE
1eny_ AAAAAAAAAF
1e7w_A AAAAAAAAAG
1a4u_A AAAAAAAAAH
1nas_ AAAAAAAAAI
1kep_A AAAAAAAAAJ
1i24_A AAAAAAAAAK
1fds_ AAAAAAAAAL
1rkx_A AAAAAAAAAM
1gz6_A AAAAAAAAAN
