seq041 AAAAAAAAAA
seq043 AAAAAAAAAB
seq002 AAAAAAAAAC
seq018 AAAAAAAAAD
seq025 AAAAAAAAAE
seq024 AAAAAAAAAF
