seq013 AAAAAAAAAA
seq010 AAAAAAAAAB
seq011 AAAAAAAAAC
seq035 AAAAAAAAAD
seq019 AAAAAAAAAE
seq079 AAAAAAAAAF
seq073 AAAAAAAAAG
seq099 AAAAAAAAAH
seq091 AAAAAAAAAI
seq097 AAAAAAAAAJ
seq095 AAAAAAAAAK
seq067 AAAAAAAAAL
seq005 AAAAAAAAAM
seq061 AAAAAAAAAN
seq060 AAAAAAAAAO
seq021 AAAAAAAAAP
seq024 AAAAAAAAAQ
seq049 AAAAAAAAAR
seq045 AAAAAAAAAS
seq044 AAAAAAAAAT
seq089 AAAAAAAAAU
seq084 AAAAAAAAAV
