ABL_DROME AAAAAAAAAA
ABL1_HUMAN AAAAAAAAAQ
CEK2_CHICK AAAAAAAAAC
CSK_CHICK AAAAAAAAAD
PTK6_MOUSE AAAAAAAAAN
BTKL_DROME AAAAAAAAAI
EPA1_HUMAN AAAAAAAAAG
SRK2_SPOLA AAAAAAAAAH
STK_HYDAT AAAAAAAAAT
EPA3_BRARE AAAAAAAAAK
1csn_ AAAAAAAAAL
EPA7_CHICK AAAAAAAAAM
SR42_DROME AAAAAAAAAF
SRMS_MOUSE AAAAAAAAAS
FGR1_CHICK AAAAAAAAAO
M3K9_HUMAN AAAAAAAAAP
YRK_CHICK AAAAAAAAAB
SRC1_XENLA AAAAAAAAAR
ACK1_HUMAN AAAAAAAAAE
SR64_DROME AAAAAAAAAJ
SRK1_SPOLA AAAAAAAAAU
