1glo_A AAAAAAAAAA
CYS3_HOMAM AAAAAAAAAF
1cpj_A AAAAAAAAAC
CATC_SCHMA AAAAAAAAAD
CAL1_GIALA AAAAAAAAAE
CATL_BRUPA AAAAAAAAAB
CYS2_HOMAM AAAAAAAAAG
CATM_MOUSE AAAAAAAAAH
PAP3_CARPA AAAAAAAAAI
CATL_DROME AAAAAAAAAJ
CPR1_DROME AAAAAAAAAK
CYS1_LEIPI AAAAAAAAAL
1m6d_A AAAAAAAAAM
CATL_SARPE AAAAAAAAAN
CYS1_DICDI AAAAAAAAAO
CYS2_LEIPI AAAAAAAAAP
