1fov_A AAAAAAAAAA
THIO_EMENI AAAAAAAAAB
THIM_PEA AAAAAAAAAC
1j0f_A AAAAAAAAAD
CCMG_PARDE AAAAAAAAAE
THIO_CHLPN AAAAAAAAAF
TYPX_TRYBB AAAAAAAAAG
GLRX_ORYSA AAAAAAAAAH
DSBE_VIBCH AAAAAAAAAI
