POLG_HPAV2 AAAAAAAAAA
1al2_ac AAAAAAAAAB
POLG_EC16H AAAAAAAAAC
POLG_TMEVB AAAAAAAAAD
POLG_HRV1A AAAAAAAAAE
POLG_HRV89 AAAAAAAAAF
POLG_EC22H AAAAAAAAAG
POLG_CXA21 AAAAAAAAAH
