SYE1_THETN AAAAAAAAAT
SYE_BACHD AAAAAAAAAB
SYE_HAEDU AAAAAAAAAC
SYE_BORBU AAAAAAAAAD
SYE_LACPL AAAAAAAAAE
SYE_WIGBR AAAAAAAAAF
1g59_A AAAAAAAAAG
SYE_STAAM AAAAAAAAAH
SYE_RALSO AAAAAAAAAI
1nzj_A AAAAAAAAAJ
SYE_BIFLO AAAAAAAAAK
SYE_ECO57 AAAAAAAAAL
SYE_DEIRA AAAAAAAAAM
SYE_BACTN AAAAAAAAAN
SYE_ARATH AAAAAAAAAO
SYE_SYNEL AAAAAAAAAP
SYE_NITEU AAAAAAAAAQ
SYE_BRAJA AAAAAAAAAR
SYE1_RICCN AAAAAAAAAS
SYE_GLOVI AAAAAAAAAA
