seq049 AAAAAAAAAA
seq070 AAAAAAAAAB
seq100 AAAAAAAAAC
seq034 AAAAAAAAAD
seq020 AAAAAAAAAE
seq024 AAAAAAAAAF
