NLG2_HUMAN AAAAAAAAAA
ESTM_MOUSE AAAAAAAAAT
CEL_HUMAN AAAAAAAAAC
1k4y_A AAAAAAAAAD
1akn_ AAAAAAAAAE
1cle_A AAAAAAAAAN
CRYS_DICDI AAAAAAAAAG
ACE1_ANOGA AAAAAAAAAH
1dx4_A AAAAAAAAAI
PCD_ARTOX AAAAAAAAAJ
ACES_BOVIN AAAAAAAAAK
EST4_RAT AAAAAAAAAL
EST1_MESAU AAAAAAAAAM
EST1_CAEBR AAAAAAAAAF
ACES_BRARE AAAAAAAAAO
ACE1_CAEBR AAAAAAAAAP
CEL_MOUSE AAAAAAAAAQ
EST2_RABIT AAAAAAAAAR
EST2_CAEEL AAAAAAAAAS
ES10_RAT AAAAAAAAAB
THYG_MOUSE AAAAAAAAAU
ACES_ELEEL AAAAAAAAAV
