seq015 AAAAAAAAAA
seq026 AAAAAAAAAH
seq012 AAAAAAAAAC
seq017 AAAAAAAAAD
seq007 AAAAAAAAAE
seq006 AAAAAAAAAF
seq022 AAAAAAAAAG
seq031 AAAAAAAAAB
seq025 AAAAAAAAAI
seq033 AAAAAAAAAJ
