seq013 AAAAAAAAAA
seq011 AAAAAAAAAB
seq008 AAAAAAAAAC
seq021 AAAAAAAAAD
seq019 AAAAAAAAAE
seq027 AAAAAAAAAF
seq026 AAAAAAAAAG
