ACSA_NEUCR AAAAAAAAAA
ACS1_YEAST AAAAAAAAAB
AC2L_HUMAN AAAAAAAAAC
ACSA_MYCBO AAAAAAAAAD
ACSA_DROME AAAAAAAAAE
ACSA_PRB01 AAAAAAAAAF
YZ68_PSEAE AAAAAAAAAS
ACS2_RHIME AAAAAAAAAR
ACSA_PYRAE AAAAAAAAAI
ACSA_CAUCR AAAAAAAAAJ
ACSA_CAMJE AAAAAAAAAK
ACS1_KLULA AAAAAAAAAL
1amu_A AAAAAAAAAM
ACSA_XYLFA AAAAAAAAAN
ACSA_PHYBL AAAAAAAAAO
ACSA_RHOCA AAAAAAAAAP
ACSA_HELPY AAAAAAAAAQ
ACSA_PASMU AAAAAAAAAH
ACSA_SHEON AAAAAAAAAG
ACSA_ALCEU AAAAAAAAAT
