seq019 AAAAAAAAAI
seq047 AAAAAAAAAC
seq050 AAAAAAAAAD
seq032 AAAAAAAAAJ
seq002 AAAAAAAAAE
seq005 AAAAAAAAAF
seq004 AAAAAAAAAG
seq036 AAAAAAAAAH
seq037 AAAAAAAAAA
seq025 AAAAAAAAAB
