ACSA_SCHPO AAAAAAAAAG
ACSA_XANAC AAAAAAAAAB
ACSA_CANAL AAAAAAAAAC
ENTF_ECO57 AAAAAAAAAD
ACSA_SYNEL AAAAAAAAAE
DLTA_BACSU AAAAAAAAAF
PRPE_ECOLI AAAAAAAAAA
ACS1_PSEAE AAAAAAAAAH
