seq027 AAAAAAAAAP
seq049 AAAAAAAAAA
seq014 AAAAAAAAAK
seq056 AAAAAAAAAC
seq044 AAAAAAAAAD
seq053 AAAAAAAAAE
seq013 AAAAAAAAAG
seq011 AAAAAAAAAH
seq016 AAAAAAAAAI
seq039 AAAAAAAAAJ
seq007 AAAAAAAAAB
seq006 AAAAAAAAAL
seq022 AAAAAAAAAM
seq036 AAAAAAAAAN
seq019 AAAAAAAAAO
seq030 AAAAAAAAAF
seq024 AAAAAAAAAQ
