CYC_CRIFA AAAAAAAAAA
CY2_RHOSH AAAAAAAAAB
CYSD_CHLLT AAAAAAAAAC
CYC_THELA AAAAAAAAAD
CYC_TETPY AAAAAAAAAE
CYC_EUGGR AAAAAAAAAF
