seq040 AAAAAAAAAC
seq001 AAAAAAAAAD
seq011 AAAAAAAAAE
seq039 AAAAAAAAAA
seq015 AAAAAAAAAB
seq034 AAAAAAAAAF
seq018 AAAAAAAAAG
seq032 AAAAAAAAAH
seq017 AAAAAAAAAI
