seq049 AAAAAAAAAA
seq058 AAAAAAAAAB
seq100 AAAAAAAAAC
seq057 AAAAAAAAAD
seq103 AAAAAAAAAE
seq052 AAAAAAAAAF
seq039 AAAAAAAAAG
seq112 AAAAAAAAAK
seq085 AAAAAAAAAI
seq031 AAAAAAAAAJ
seq095 AAAAAAAAAH
