seq012 AAAAAAAAAA
seq009 AAAAAAAAAB
seq010 AAAAAAAAAC
seq011 AAAAAAAAAD
seq038 AAAAAAAAAE
seq017 AAAAAAAAAF
seq014 AAAAAAAAAG
seq035 AAAAAAAAAH
seq018 AAAAAAAAAI
seq037 AAAAAAAAAL
seq033 AAAAAAAAAK
seq019 AAAAAAAAAJ
seq029 AAAAAAAAAM
seq002 AAAAAAAAAN
seq023 AAAAAAAAAO
seq022 AAAAAAAAAP
seq020 AAAAAAAAAQ
seq026 AAAAAAAAAR
seq025 AAAAAAAAAS
seq045 AAAAAAAAAT
seq047 AAAAAAAAAU
seq046 AAAAAAAAAV
seq041 AAAAAAAAAW
seq040 AAAAAAAAAX
seq043 AAAAAAAAAY
