seq007 AAAAAAAAAA
seq003 AAAAAAAAAD
seq013 AAAAAAAAAC
seq010 AAAAAAAAAB
seq014 AAAAAAAAAE
seq022 AAAAAAAAAF
seq021 AAAAAAAAAG
seq027 AAAAAAAAAH
seq026 AAAAAAAAAI
seq025 AAAAAAAAAJ
seq024 AAAAAAAAAK
