seq019 AAAAAAAAAB
seq020 AAAAAAAAAI
seq029 AAAAAAAAAE
seq001 AAAAAAAAAD
seq010 AAAAAAAAAC
seq017 AAAAAAAAAF
seq034 AAAAAAAAAG
seq036 AAAAAAAAAH
seq037 AAAAAAAAAA
seq025 AAAAAAAAAJ
seq024 AAAAAAAAAK
