seq061 AAAAAAAAAN
seq012 AAAAAAAAAB
seq014 AAAAAAAAAC
seq015 AAAAAAAAAD
seq037 AAAAAAAAAE
seq031 AAAAAAAAAF
seq059 AAAAAAAAAG
seq056 AAAAAAAAAH
seq057 AAAAAAAAAI
seq067 AAAAAAAAAJ
seq003 AAAAAAAAAK
seq028 AAAAAAAAAL
seq005 AAAAAAAAAM
seq007 AAAAAAAAAA
seq009 AAAAAAAAAO
seq027 AAAAAAAAAP
seq024 AAAAAAAAAQ
seq049 AAAAAAAAAR
seq044 AAAAAAAAAS
seq047 AAAAAAAAAT
seq040 AAAAAAAAAU
seq042 AAAAAAAAAV
seq063 AAAAAAAAAW
