SYS_NEIMA AAAAAAAAAA
SYS_STAAM AAAAAAAAAB
SYS_ANASP AAAAAAAAAC
SYS_CHLTE AAAAAAAAAD
SYS_MYCPU AAAAAAAAAE
SYS2_LACPL AAAAAAAAAF
1ser_A AAAAAAAAAN
SYS_MYCLE AAAAAAAAAG
SYP_MYCGE AAAAAAAAAH
YHI0_YEAST AAAAAAAAAJ
SYS_DEIRA AAAAAAAAAK
SYS_XYLFA AAAAAAAAAL
SYS_RALSO AAAAAAAAAM
SYS_HALN1 AAAAAAAAAI
