1fov_A AAAAAAAAAA
THIO_EMENI AAAAAAAAAB
THIO_STAAM AAAAAAAAAC
THIO_NEUCR AAAAAAAAAD
THIO_CYACA AAAAAAAAAE
THIO_RHOSH AAAAAAAAAF
THI1_CAEEL AAAAAAAAAG
THH2_BRANA AAAAAAAAAH
THIO_CHLPN AAAAAAAAAI
THM4_ARATH AAAAAAAAAJ
THI2_BOVIN AAAAAAAAAK
THIO_GEOCY AAAAAAAAAL
THF1_ARATH AAAAAAAAAM
THIO_LISMO AAAAAAAAAN
THI2_CHLTE AAAAAAAAAO
TXL2_HUMAN AAAAAAAAAP
