seq026 AAAAAAAAAE
seq005 AAAAAAAAAB
seq018 AAAAAAAAAC
seq042 AAAAAAAAAA
seq036 AAAAAAAAAD
seq024 AAAAAAAAAF
