seq048 AAAAAAAAAA
seq059 AAAAAAAAAB
seq044 AAAAAAAAAC
seq075 AAAAAAAAAD
seq012 AAAAAAAAAE
seq032 AAAAAAAAAK
seq023 AAAAAAAAAG
seq035 AAAAAAAAAH
seq018 AAAAAAAAAI
seq019 AAAAAAAAAJ
seq069 AAAAAAAAAF
