seq025 AAAAAAAAAT
seq002 AAAAAAAAAM
seq044 AAAAAAAAAD
seq041 AAAAAAAAAF
seq036 AAAAAAAAAP
seq022 AAAAAAAAAO
seq031 AAAAAAAAAS
seq010 AAAAAAAAAI
seq028 AAAAAAAAAJ
seq038 AAAAAAAAAK
seq039 AAAAAAAAAG
seq014 AAAAAAAAAC
seq006 AAAAAAAAAN
seq004 AAAAAAAAAU
seq008 AAAAAAAAAE
seq021 AAAAAAAAAB
seq019 AAAAAAAAAQ
seq035 AAAAAAAAAR
seq026 AAAAAAAAAH
seq032 AAAAAAAAAA
seq017 AAAAAAAAAL
