seq001 AAAAAAAAAE
seq045 AAAAAAAAAB
seq046 AAAAAAAAAC
seq040 AAAAAAAAAD
seq012 AAAAAAAAAA
seq016 AAAAAAAAAF
seq014 AAAAAAAAAG
seq023 AAAAAAAAAH
seq035 AAAAAAAAAI
seq033 AAAAAAAAAJ
