BACR_HALAR AAAAAAAAAA
BACS_HALHA AAAAAAAAAB
BACR_HALHM AAAAAAAAAC
BAC1_HALS1 AAAAAAAAAD
YRO2_YEAST AAAAAAAAAE
BACR_HALHP AAAAAAAAAF
F123_CORVE AAAAAAAAAG
Q9UW81 AAAAAAAAAH
BACR_HALSR AAAAAAAAAI
BACH_HALHS AAAAAAAAAJ
