THCC_RHOER AAAAAAAAAA
ADXH_DROME AAAAAAAAAB
1i7h_A AAAAAAAAAC
2pia_ AAAAAAAAAD
FER_HAEIN AAAAAAAAAQ
PAAE_ECOLI AAAAAAAAAJ
FER_BUCAP AAAAAAAAAT
FER_BUCBP AAAAAAAAAG
ADRX_YEAST AAAAAAAAAH
XYLZ_PSEPU AAAAAAAAAI
FER5_AQUAE AAAAAAAAAF
FER_BUCAI AAAAAAAAAK
ETP1_SCHPO AAAAAAAAAL
TERP_PSESP AAAAAAAAAM
ADX_CHICK AAAAAAAAAN
FER_PSEAE AAAAAAAAAP
FER6_RHOCA AAAAAAAAAO
FER2_CAUCR AAAAAAAAAR
ADX1_BOVIN AAAAAAAAAU
FDX2_RICCN AAAAAAAAAE
PUTX_PSEPU AAAAAAAAAS
