O96562 AAAAAAAAAA
Q2TUT9 AAAAAAAAAB
Q61JK3 AAAAAAAAAC
P22736 AAAAAAAAAD
Q1HCL4 AAAAAAAAAE
