seq037 AAAAAAAAAQ
seq206 AAAAAAAAAC
seq205 AAAAAAAAAD
seq129 AAAAAAAAAE
seq070 AAAAAAAAAF
seq157 AAAAAAAAAR
seq338 AAAAAAAAAH
seq120 AAAAAAAAAK
seq314 AAAAAAAAAS
seq351 AAAAAAAAAJ
seq191 AAAAAAAAAT
seq111 AAAAAAAAAL
seq176 AAAAAAAAAM
seq092 AAAAAAAAAN
seq022 AAAAAAAAAO
seq090 AAAAAAAAAP
seq280 AAAAAAAAAB
seq096 AAAAAAAAAG
seq291 AAAAAAAAAI
seq142 AAAAAAAAAA
