Q6UAP1 AAAAAAAAAA
P29460 AAAAAAAAAB
Q6UAP2 AAAAAAAAAC
Q6F3Q9 AAAAAAAAAD
Q2PCT1 AAAAAAAAAE
