Q60846 AAAAAAAAAA
Q8C4K3 AAAAAAAAAB
Q4S672 AAAAAAAAAC
Q805B0 AAAAAAAAAD
Q1ECV9 AAAAAAAAAE
O35305 AAAAAAAAAF
Q3UK82 AAAAAAAAAG
Q07011 AAAAAAAAAH
