CYC_CRIFA AAAAAAAAAA
CYC1_YEAST AAAAAAAAAB
CYCY_RHOCA AAAAAAAAAC
CY2_RHOVA AAAAAAAAAD
CYC_ENTIN AAAAAAAAAE
CYC_HELAS AAAAAAAAAF
1dvh_ AAAAAAAAAG
C550_PARPN AAAAAAAAAH
CYC_EUGGR AAAAAAAAAQ
CYC_APIME AAAAAAAAAP
C551_ROSDE AAAAAAAAAK
CYC_SAMCY AAAAAAAAAL
CY2_RHOGL AAAAAAAAAN
CYC_TETPY AAAAAAAAAM
CYC2_CAEEL AAAAAAAAAI
CY2_RHOCA AAAAAAAAAO
CYC1_ARATH AAAAAAAAAJ
CYC_SCHPO AAAAAAAAAR
