1b8g_A AAAAAAAAAA
GSA_PASMU AAAAAAAAAB
GSA_XANAC AAAAAAAAAC
GSA_CHLRE AAAAAAAAAD
GSA_BACHD AAAAAAAAAF
1jg8_A AAAAAAAAAG
GSAB_BACSU AAAAAAAAAR
1ax4_A AAAAAAAAAH
GSA_VIBCH AAAAAAAAAJ
GSA_CLOAB AAAAAAAAAK
1fg3_A AAAAAAAAAL
2gsa_A AAAAAAAAAM
GSA_METKA AAAAAAAAAI
GSA_AQUAE AAAAAAAAAO
GSA_SOYBN AAAAAAAAAP
GSA_MYCLE AAAAAAAAAQ
1d2f_A AAAAAAAAAS
GSA_CLOPE AAAAAAAAAE
GSA_METAC AAAAAAAAAN
