Q9Y1Y9 AAAAAAAAAA
P00520 AAAAAAAAAB
P41243 AAAAAAAAAC
Q9Y1Y3 AAAAAAAAAD
P53356 AAAAAAAAAE
O76978 AAAAAAAAAF
Q05397 AAAAAAAAAG
Q00993 AAAAAAAAAH
Q90601 AAAAAAAAAI
