SYE_SULSO AAAAAAAAAD
SYE_METJA AAAAAAAAAN
SYEP_DROME AAAAAAAAAC
SYE_METTH AAAAAAAAAA
SYQ_NEIMA AAAAAAAAAE
SYEC_YEAST AAAAAAAAAF
SYE_ARCFU AAAAAAAAAG
SYQ_CAEEL AAAAAAAAAH
SYQ_HUMAN AAAAAAAAAI
SYQ_BUCBP AAAAAAAAAJ
SYQ_HAEIN AAAAAAAAAK
SYE_THEAC AAAAAAAAAL
SYQ_LUPLU AAAAAAAAAM
SYE_AERPE AAAAAAAAAB
SYEC_SCHPO AAAAAAAAAO
1euq_A AAAAAAAAAP
SYE_METKA AAAAAAAAAQ
SYE_SULTO AAAAAAAAAR
SYE_PYRAB AAAAAAAAAS
SYEP_HUMAN AAAAAAAAAT
SYQ_DROME AAAAAAAAAU
SYE_THEVO AAAAAAAAAV
SYQ_DEIRA AAAAAAAAAW
