seq011 AAAAAAAAAH
seq007 AAAAAAAAAK
seq023 AAAAAAAAAM
seq022 AAAAAAAAAN
seq012 AAAAAAAAAE
seq013 AAAAAAAAAF
seq003 AAAAAAAAAG
seq002 AAAAAAAAAB
seq005 AAAAAAAAAI
seq017 AAAAAAAAAJ
seq014 AAAAAAAAAA
seq006 AAAAAAAAAL
seq009 AAAAAAAAAD
seq008 AAAAAAAAAC
seq018 AAAAAAAAAO
seq020 AAAAAAAAAP
seq024 AAAAAAAAAQ
