P48562 AAAAAAAAAG
Q6FJT6 AAAAAAAAAB
Q6TGI6 AAAAAAAAAF
Q6BWC4 AAAAAAAAAD
Q551M5 AAAAAAAAAE
P35465 AAAAAAAAAC
Q9HEW3 AAAAAAAAAA
Q5APR8 AAAAAAAAAN
Q6IWN3 AAAAAAAAAI
Q9C3Z3 AAAAAAAAAJ
Q9P496 AAAAAAAAAK
Q68ST5 AAAAAAAAAL
Q6CXL0 AAAAAAAAAM
Q9HFW2 AAAAAAAAAH
