seq103 AAAAAAAAAA
seq070 AAAAAAAAAB
seq047 AAAAAAAAAC
seq073 AAAAAAAAAD
seq040 AAAAAAAAAE
seq076 AAAAAAAAAF
seq051 AAAAAAAAAG
seq013 AAAAAAAAAH
seq083 AAAAAAAAAO
seq043 AAAAAAAAAI
seq023 AAAAAAAAAK
seq080 AAAAAAAAAL
seq018 AAAAAAAAAJ
seq096 AAAAAAAAAN
seq021 AAAAAAAAAM
seq034 AAAAAAAAAP
seq017 AAAAAAAAAQ
