BCL3_HUMAN_1 AAAAAAAAAA
BCL3_HUMAN_3 AAAAAAAAAB
BCL3_HUMAN_7 AAAAAAAAAC
CACT_DROME_6 AAAAAAAAAD
CACT_DROME_7 AAAAAAAAAE
CACT_DROME_3 AAAAAAAAAF
CACT_DROME_1 AAAAAAAAAG
