seq241 AAAAAAAAAK
seq489 AAAAAAAAAA
seq468 AAAAAAAAAB
seq148 AAAAAAAAAD
seq387 AAAAAAAAAE
seq396 AAAAAAAAAF
seq467 AAAAAAAAAG
seq195 AAAAAAAAAJ
seq169 AAAAAAAAAH
seq359 AAAAAAAAAI
seq447 AAAAAAAAAC
seq349 AAAAAAAAAL
