Q38J75 AAAAAAAAAA
P22457 AAAAAAAAAB
Q8K3U6 AAAAAAAAAC
Q804X7 AAAAAAAAAD
P08709 AAAAAAAAAE
Q19AZ7 AAAAAAAAAF
Q6GNA2 AAAAAAAAAG
