seq015 AAAAAAAAAA
seq035 AAAAAAAAAB
seq018 AAAAAAAAAD
seq078 AAAAAAAAAE
seq058 AAAAAAAAAF
seq059 AAAAAAAAAG
seq055 AAAAAAAAAH
seq051 AAAAAAAAAI
seq068 AAAAAAAAAJ
seq064 AAAAAAAAAT
seq005 AAAAAAAAAL
seq021 AAAAAAAAAM
seq020 AAAAAAAAAN
seq027 AAAAAAAAAO
seq024 AAAAAAAAAP
seq049 AAAAAAAAAQ
seq044 AAAAAAAAAR
seq041 AAAAAAAAAS
seq028 AAAAAAAAAC
seq002 AAAAAAAAAK
seq083 AAAAAAAAAU
seq085 AAAAAAAAAV
seq084 AAAAAAAAAW
seq086 AAAAAAAAAX
