seq079 AAAAAAAAAA
seq117 AAAAAAAAAI
seq111 AAAAAAAAAM
seq135 AAAAAAAAAC
seq134 AAAAAAAAAD
seq073 AAAAAAAAAF
seq089 AAAAAAAAAG
seq043 AAAAAAAAAH
seq012 AAAAAAAAAE
seq114 AAAAAAAAAJ
seq005 AAAAAAAAAK
seq004 AAAAAAAAAL
seq014 AAAAAAAAAB
seq034 AAAAAAAAAN
seq022 AAAAAAAAAO
seq083 AAAAAAAAAP
seq069 AAAAAAAAAQ
