1o5i_A AAAAAAAAAA
FABG_ACTAC AAAAAAAAAB
1kep_A AAAAAAAAAC
YOHF_ECOLI AAAAAAAAAD
TRNH_DATST AAAAAAAAAE
FABG_BUCAP AAAAAAAAAF
RFBE_SALTI AAAAAAAAAG
