ESTJ_HELVI AAAAAAAAAA
NLG4_HUMAN AAAAAAAAAC
1dx4_A AAAAAAAAAB
PCD_ARTOX AAAAAAAAAE
ESTE_MYZPE AAAAAAAAAF
1akn_ AAAAAAAAAG
EST1_CAEBR AAAAAAAAAH
THYG_MOUSE AAAAAAAAAI
EST1_CULPI AAAAAAAAAM
EST2_CAEEL AAAAAAAAAJ
CRYS_DICDI AAAAAAAAAK
EST6_DROMA AAAAAAAAAL
1acj_ AAAAAAAAAD
