Q6IDV0 AAAAAAAAAA
Q24174 AAAAAAAAAB
P17789 AAAAAAAAAD
A1A5F0 AAAAAAAAAC
Q52KB5 AAAAAAAAAE
O15060 AAAAAAAAAF
LOLA3_DROME__1 AAAAAAAAAG
