seq012 AAAAAAAAAA
seq013 AAAAAAAAAB
seq010 AAAAAAAAAC
seq002 AAAAAAAAAD
seq014 AAAAAAAAAE
seq015 AAAAAAAAAF
seq008 AAAAAAAAAG
seq019 AAAAAAAAAH
seq027 AAAAAAAAAI
seq024 AAAAAAAAAJ
