seq047 AAAAAAAAAA
seq055 AAAAAAAAAB
seq051 AAAAAAAAAD
seq001 AAAAAAAAAE
seq004 AAAAAAAAAJ
seq039 AAAAAAAAAF
seq014 AAAAAAAAAG
seq018 AAAAAAAAAH
seq032 AAAAAAAAAI
seq062 AAAAAAAAAC
