THCC_RHOER AAAAAAAAAA
ADXH_DROME AAAAAAAAAB
1i7h_A AAAAAAAAAC
VANB_PSEPU AAAAAAAAAD
VANB_PSES9 AAAAAAAAAE
FER_BUCAP AAAAAAAAAF
TERP_PSESP AAAAAAAAAU
DMPP_ACICA AAAAAAAAAG
FER_HAEIN AAAAAAAAAH
RFBI_SALTY AAAAAAAAAI
PAAE_ECOLI AAAAAAAAAJ
1jq4_A AAAAAAAAAL
VANB_ACICA AAAAAAAAAM
NQRF_PSEAE AAAAAAAAAN
MMOC_METTR AAAAAAAAAO
YEAX_ECOLI AAAAAAAAAP
FER6_RHOCA AAAAAAAAAK
ASCD_YERPE AAAAAAAAAR
FER_HALMA AAAAAAAAAT
ETP1_SCHPO AAAAAAAAAS
PHT2_PSEPU AAAAAAAAAQ
