Q9JI97 AAAAAAAAAA
Q9DE35 AAAAAAAAAB
Q90375 AAAAAAAAAD
P10912 AAAAAAAAAC
Q9PTI1 AAAAAAAAAE
P16882 AAAAAAAAAF
Q9N0Y7 AAAAAAAAAG
