1a04_A AAAAAAAAAA
RDGA_ERWCA AAAAAAAAAB
POU1_XENLA AAAAAAAAAC
AGMR_PSEAE AAAAAAAAAD
ZP50_BRARE AAAAAAAAAH
PO3A_XENLA AAAAAAAAAE
HM16_XENLA AAAAAAAAAF
PDM2_DROME AAAAAAAAAG
PO32_HUMAN AAAAAAAAAI
BVGA_BORPE AAAAAAAAAJ
PO21_CHICK AAAAAAAAAK
