TRYZ_DROER AAAAAAAAAA
1bru_P AAAAAAAAAB
1a0j_A AAAAAAAAAC
COGS_UCAPU AAAAAAAAAD
GRAB_MOUSE AAAAAAAAAE
KLKA_HUMAN AAAAAAAAAF
TRY3_ANOGA AAAAAAAAAG
TEST_MOUSE AAAAAAAAAH
GRAM_RAT AAAAAAAAAI
1a0h_B AAAAAAAAAJ
1ton_ AAAAAAAAAK
TRYE_DROER AAAAAAAAAO
VDP_BOMMO AAAAAAAAAM
TRYI_DROME AAAAAAAAAN
TRYP_STRGA AAAAAAAAAL
