Q8hxy7 AAAAAAAAAA
Q20772 AAAAAAAAAB
1rx0_A AAAAAAAAAC
Q8jzn5 AAAAAAAAAD
Q9kje8 AAAAAAAAAE
1buc_A AAAAAAAAAF
P76200 AAAAAAAAAG
P05335 AAAAAAAAAH
1is2_A AAAAAAAAAI
1ivh_A AAAAAAAAAJ
P45954 AAAAAAAAAK
Q9vsa3 AAAAAAAAAL
