P43630 AAAAAAAAAA
CD22_HUMAN AAAAAAAAAB
Q67EV2 AAAAAAAAAD
Q8MJZ7 AAAAAAAAAC
P0C1X9 AAAAAAAAAE
Q5ZJ90 AAAAAAAAAF
