seq012 AAAAAAAAAA
seq029 AAAAAAAAAB
seq064 AAAAAAAAAC
seq030 AAAAAAAAAD
seq026 AAAAAAAAAE
