seq041 AAAAAAAAAA
seq051 AAAAAAAAAB
seq066 AAAAAAAAAC
seq063 AAAAAAAAAD
seq039 AAAAAAAAAE
seq006 AAAAAAAAAF
seq016 AAAAAAAAAG
