1a3w_A AAAAAAAAAA
KPYK_MYCGE AAAAAAAAAC
KPYK_METEX AAAAAAAAAB
KPY2_ECOLI AAAAAAAAAD
KPY1_SYNY3 AAAAAAAAAE
KPYK_LACDE AAAAAAAAAF
KPYG_RICCO AAAAAAAAAG
KPYK_BORBU AAAAAAAAAH
KPYK_THELI AAAAAAAAAI
KPYK_THEAC AAAAAAAAAJ
KPYK_METJA AAAAAAAAAM
KPYC_ARATH AAAAAAAAAL
KPYK_CHLMU AAAAAAAAAK
