1d9k_A AAAAAAAAAA
1hnf_ AAAAAAAAAB
1bqs_A AAAAAAAAAC
1wit_ AAAAAAAAAD
1cvs_C AAAAAAAAAE
1vca_A AAAAAAAAAF
1nbq_A AAAAAAAAAG
1rhf_A AAAAAAAAAH
1tlk_ AAAAAAAAAI
2ncm_ AAAAAAAAAJ
