C1GA_BACTU AAAAAAAAAA
C9DA_BACTP AAAAAAAAAB
C1HA_BACTU AAAAAAAAAC
C1GB_BACTZ AAAAAAAAAD
C3CA_BACTK AAAAAAAAAE
1ciy_ AAAAAAAAAF
C8AA_BACUK AAAAAAAAAG
1i5p_A AAAAAAAAAH
C8CA_BACTP AAAAAAAAAI
C1IA_BACTK AAAAAAAAAJ
C1CA_BACTE AAAAAAAAAK
C1BC_BACTM AAAAAAAAAL
C9EA_BACTA AAAAAAAAAM
C1FA_BACTA AAAAAAAAAN
