Q70G59 AAAAAAAAAH
Q3TZM2 AAAAAAAAAB
Q9TZX0 AAAAAAAAAC
Q4JEV7 AAAAAAAAAD
O76848 AAAAAAAAAE
Q5EVN0 AAAAAAAAAF
Q7YTB6 AAAAAAAAAG
P02836 AAAAAAAAAA
P34326 AAAAAAAAAI
