seq108 AAAAAAAAAA
seq128 AAAAAAAAAB
seq101 AAAAAAAAAC
seq124 AAAAAAAAAD
seq073 AAAAAAAAAE
seq066 AAAAAAAAAF
seq115 AAAAAAAAAG
seq006 AAAAAAAAAH
seq023 AAAAAAAAAI
seq151 AAAAAAAAAJ
seq057 AAAAAAAAAK
