seq046 AAAAAAAAAS
seq038 AAAAAAAAAB
seq017 AAAAAAAAAC
seq015 AAAAAAAAAD
seq035 AAAAAAAAAE
seq019 AAAAAAAAAF
seq031 AAAAAAAAAG
seq058 AAAAAAAAAH
seq057 AAAAAAAAAI
seq072 AAAAAAAAAJ
seq076 AAAAAAAAAK
seq093 AAAAAAAAAL
seq005 AAAAAAAAAM
seq007 AAAAAAAAAN
seq060 AAAAAAAAAO
seq008 AAAAAAAAAP
seq100 AAAAAAAAAQ
seq047 AAAAAAAAAR
seq103 AAAAAAAAAA
seq106 AAAAAAAAAT
seq042 AAAAAAAAAU
seq045 AAAAAAAAAV
seq071 AAAAAAAAAW
seq080 AAAAAAAAAX
seq085 AAAAAAAAAY
