P32120 AAAAAAAAAA
Q8MYB1 AAAAAAAAAB
Q16NE5 AAAAAAAAAC
Q5WNA5 AAAAAAAAAD
Q86BW6 AAAAAAAAAE
Q9V393 AAAAAAAAAF
