seq002 AAAAAAAAAH
seq010 AAAAAAAAAD
seq001 AAAAAAAAAC
seq003 AAAAAAAAAB
seq011 AAAAAAAAAE
seq005 AAAAAAAAAF
seq004 AAAAAAAAAG
seq007 AAAAAAAAAA
seq006 AAAAAAAAAI
seq009 AAAAAAAAAJ
seq008 AAAAAAAAAK
