seq049 AAAAAAAAAA
seq070 AAAAAAAAAB
seq055 AAAAAAAAAC
seq040 AAAAAAAAAD
seq042 AAAAAAAAAE
seq067 AAAAAAAAAF
seq029 AAAAAAAAAG
seq017 AAAAAAAAAH
seq022 AAAAAAAAAI
seq051 AAAAAAAAAJ
seq068 AAAAAAAAAK
