O14746 AAAAAAAAAA
Q01AN0 AAAAAAAAAB
Q19S68 AAAAAAAAAC
Q2NNR6 AAAAAAAAAD
Q55SG5 AAAAAAAAAE
Q4PGK2 AAAAAAAAAF
Q6C9D0 AAAAAAAAAG
Q5B6S7 AAAAAAAAAH
Q9GRC5 AAAAAAAAAI
Q7R365 AAAAAAAAAJ
O76332 AAAAAAAAAK
Q22ZB5 AAAAAAAAAL
Q6CSS0 AAAAAAAAAM
Q0QHL8 AAAAAAAAAN
O13339 AAAAAAAAAO
Q8SQQ0 AAAAAAAAAP
Q54B44 AAAAAAAAAQ
Q1AN55 AAAAAAAAAR
