KTHY_MYCPN AAAAAAAAAA
KTHY_STAAM AAAAAAAAAM
KAD_DEIRA AAAAAAAAAB
F262_BOVIN AAAAAAAAAP
KTHY_LACPL AAAAAAAAAH
KCY_DICDI AAAAAAAAAD
KTHY_BRUME AAAAAAAAAE
KTHY_BUCAI AAAAAAAAAF
KAD_MICLU AAAAAAAAAL
KTHY_NEIMA AAAAAAAAAC
KGUA_UREPA AAAAAAAAAI
KGUA_DEIRA AAAAAAAAAJ
KAD_BIFLO AAAAAAAAAK
KTHY_CHLCV AAAAAAAAAG
KGUA_PSEAE AAAAAAAAAO
KGUA_CORGL AAAAAAAAAQ
KAD2_SYNY3 AAAAAAAAAN
