Q9UHK6 AAAAAAAAAA
Q22DI2 AAAAAAAAAB
A0DG77 AAAAAAAAAC
Q6CG66 AAAAAAAAAD
P78582 AAAAAAAAAE
