seq041 AAAAAAAAAA
seq029 AAAAAAAAAB
seq011 AAAAAAAAAC
seq023 AAAAAAAAAD
seq036 AAAAAAAAAE
seq019 AAAAAAAAAF
seq026 AAAAAAAAAG
