1b43_A AAAAAAAAAA
EX53_MYCGE AAAAAAAAAB
DPO1_MYCLE AAAAAAAAAC
EX53_BUCAP AAAAAAAAAD
EX53_BACSU AAAAAAAAAE
EX53_STRCO AAAAAAAAAF
DPO1_ANATH AAAAAAAAAG
EX53_AQUAE AAAAAAAAAH
DPO1_RICFE AAAAAAAAAI
DPO1_CHLAU AAAAAAAAAJ
EX53_BACHD AAAAAAAAAK
DPO1_DEIRA AAAAAAAAAL
EX53_UREPA AAAAAAAAAM
1exn_A AAAAAAAAAN
EX9_ECOLI AAAAAAAAAO
