seq015 AAAAAAAAAD
seq010 AAAAAAAAAA
seq011 AAAAAAAAAB
seq039 AAAAAAAAAC
seq022 AAAAAAAAAK
seq034 AAAAAAAAAE
seq035 AAAAAAAAAF
seq031 AAAAAAAAAG
seq056 AAAAAAAAAH
seq057 AAAAAAAAAI
seq051 AAAAAAAAAJ
seq029 AAAAAAAAAL
seq005 AAAAAAAAAM
seq062 AAAAAAAAAN
seq061 AAAAAAAAAO
seq060 AAAAAAAAAP
seq008 AAAAAAAAAQ
seq020 AAAAAAAAAR
seq026 AAAAAAAAAS
seq048 AAAAAAAAAT
seq045 AAAAAAAAAU
seq041 AAAAAAAAAV
seq042 AAAAAAAAAW
