seq001 AAAAAAAAAA
seq028 AAAAAAAAAC
seq020 AAAAAAAAAB
seq004 AAAAAAAAAD
seq017 AAAAAAAAAE
