1dar_ AAAAAAAAAA
1mky_A AAAAAAAAAB
1rfl_A AAAAAAAAAC
1kjz_A AAAAAAAAAD
1TAG_ AAAAAAAAAE
1aip_A AAAAAAAAAF
1EFT_ AAAAAAAAAG
1g7r_A AAAAAAAAAH
1ega_A AAAAAAAAAI
1n0u_A AAAAAAAAAJ
1cp2_A AAAAAAAAAK
1f60_A AAAAAAAAAL
1lnz_A AAAAAAAAAM
