TYSY_HSVE2 AAAAAAAAAA
TYSY_HUMAN AAAAAAAAAB
TYSY_ZYMMO AAAAAAAAAC
TYSY_CLOAB AAAAAAAAAD
TYSY_CRYNE AAAAAAAAAE
1ci7_A AAAAAAAAAF
TYSY_STRP8 AAAAAAAAAG
TYSY_FUSNN AAAAAAAAAH
TYSY_LACLA AAAAAAAAAI
TYSY_KSHV AAAAAAAAAJ
1tis_ AAAAAAAAAK
TYSY_YEAST AAAAAAAAAL
TYSY_DROME AAAAAAAAAM
TYSY_AGABI AAAAAAAAAN
DRTS_TOXGO AAAAAAAAAO
1aiq_A AAAAAAAAAP
TYSY_ASCSU AAAAAAAAAQ
DRTS_TRYCR AAAAAAAAAR
DUHM_BPSP1 AAAAAAAAAS
1qzf_A AAAAAAAAAT
