seq037 AAAAAAAAAP
seq059 AAAAAAAAAB
seq027 AAAAAAAAAQ
seq009 AAAAAAAAAM
seq053 AAAAAAAAAE
seq001 AAAAAAAAAG
seq013 AAAAAAAAAH
seq064 AAAAAAAAAI
seq016 AAAAAAAAAJ
seq004 AAAAAAAAAK
seq061 AAAAAAAAAL
seq021 AAAAAAAAAR
seq092 AAAAAAAAAD
seq080 AAAAAAAAAN
seq036 AAAAAAAAAO
seq091 AAAAAAAAAA
seq085 AAAAAAAAAC
seq031 AAAAAAAAAF
seq087 AAAAAAAAAS
