Q4H2Z8 AAAAAAAAAA
Q9NGC7 AAAAAAAAAB
P10360 AAAAAAAAAC
O12946 AAAAAAAAAD
Q4H301 AAAAAAAAAE
Q9H3D4 AAAAAAAAAF
