P31617 AAAAAAAAAA
P18921 AAAAAAAAAB
Q77B50 AAAAAAAAAC
Q8UYK9 AAAAAAAAAD
Q67591 AAAAAAAAAE
