1vj0_A AAAAAAAAAA
2ohx_A AAAAAAAAAB
1iyz_A AAAAAAAAAC
1vj1_A AAAAAAAAAD
1qor_A AAAAAAAAAE
1gu7_A AAAAAAAAAF
1ped_A AAAAAAAAAG
1e3j_A AAAAAAAAAH
1kol_A AAAAAAAAAI
1o89_A AAAAAAAAAJ
