Q1SDZ7 AAAAAAAAAG
Q4QAX8 AAAAAAAAAB
Q9FRH3 AAAAAAAAAC
Q5KDG1 AAAAAAAAAD
Q54Y50 AAAAAAAAAE
Q8L936 AAAAAAAAAF
Q9ZVN6 AAAAAAAAAA
Q59SI8 AAAAAAAAAI
Q00X80 AAAAAAAAAL
P94017 AAAAAAAAAJ
O55012 AAAAAAAAAH
Q67ZR5 AAAAAAAAAK
