seq011 AAAAAAAAAA
seq016 AAAAAAAAAB
seq039 AAAAAAAAAC
seq015 AAAAAAAAAD
seq035 AAAAAAAAAE
seq037 AAAAAAAAAF
seq031 AAAAAAAAAG
seq059 AAAAAAAAAH
seq056 AAAAAAAAAI
seq054 AAAAAAAAAJ
seq052 AAAAAAAAAK
seq050 AAAAAAAAAL
seq029 AAAAAAAAAM
seq005 AAAAAAAAAN
seq007 AAAAAAAAAO
seq009 AAAAAAAAAP
seq022 AAAAAAAAAQ
seq020 AAAAAAAAAR
seq027 AAAAAAAAAS
seq024 AAAAAAAAAT
seq047 AAAAAAAAAU
seq046 AAAAAAAAAV
seq003 AAAAAAAAAW
seq043 AAAAAAAAAX
seq038 AAAAAAAAAY
