TPIS_GLOVI AAAAAAAAAA
TPIS_SYNPX AAAAAAAAAB
TPIS_CHLTR AAAAAAAAAC
1hg3_A AAAAAAAAAD
TPI1_RHIME AAAAAAAAAE
TPI2_LISIN AAAAAAAAAR
TPIS_BORBR AAAAAAAAAF
TPIS_BUCBP AAAAAAAAAG
TPIS_LEPIN AAAAAAAAAI
TPIS_BUCAP AAAAAAAAAJ
TPIS_RALSO AAAAAAAAAK
TPIS_XANAC AAAAAAAAAL
TPIS_PORGI AAAAAAAAAM
TPIS_CHLTE AAAAAAAAAN
TPIS_TROW8 AAAAAAAAAO
1m6j_A AAAAAAAAAP
TPIS_PROMP AAAAAAAAAQ
1tim_A AAAAAAAAAH
TPIS_PHOLL AAAAAAAAAS
1tmh_D AAAAAAAAAT
