seq012 AAAAAAAAAH
seq020 AAAAAAAAAS
seq011 AAAAAAAAAK
seq014 AAAAAAAAAN
seq015 AAAAAAAAAO
seq010 AAAAAAAAAJ
seq001 AAAAAAAAAA
seq013 AAAAAAAAAI
seq003 AAAAAAAAAG
seq002 AAAAAAAAAD
seq016 AAAAAAAAAL
seq004 AAAAAAAAAM
seq007 AAAAAAAAAC
seq006 AAAAAAAAAF
seq009 AAAAAAAAAP
seq008 AAAAAAAAAE
seq018 AAAAAAAAAR
seq019 AAAAAAAAAB
seq021 AAAAAAAAAT
seq005 AAAAAAAAAQ
seq017 AAAAAAAAAU
