seq109 AAAAAAAAAP
seq025 AAAAAAAAAO
seq066 AAAAAAAAAM
seq027 AAAAAAAAAN
seq057 AAAAAAAAAG
seq054 AAAAAAAAAH
seq073 AAAAAAAAAI
seq134 AAAAAAAAAS
seq120 AAAAAAAAAR
seq067 AAAAAAAAAL
seq013 AAAAAAAAAA
seq087 AAAAAAAAAT
seq016 AAAAAAAAAB
seq119 AAAAAAAAAJ
seq015 AAAAAAAAAC
seq035 AAAAAAAAAD
seq037 AAAAAAAAAE
seq096 AAAAAAAAAK
seq032 AAAAAAAAAF
seq129 AAAAAAAAAQ
