seq187 AAAAAAAAAM
seq034 AAAAAAAAAR
seq103 AAAAAAAAAB
seq178 AAAAAAAAAO
seq046 AAAAAAAAAE
seq052 AAAAAAAAAF
seq040 AAAAAAAAAG
seq132 AAAAAAAAAH
seq197 AAAAAAAAAN
seq158 AAAAAAAAAJ
seq005 AAAAAAAAAK
seq149 AAAAAAAAAL
seq165 AAAAAAAAAC
seq023 AAAAAAAAAI
seq093 AAAAAAAAAD
seq080 AAAAAAAAAP
seq097 AAAAAAAAAQ
seq119 AAAAAAAAAA
seq143 AAAAAAAAAS
