MT10_YEAST AAAAAAAAAA
RFBI_SALTY AAAAAAAAAB
YB63_SCHPO AAAAAAAAAC
1fdr_ AAAAAAAAAD
1ep1_B AAAAAAAAAE
XYLZ_PSEPU AAAAAAAAAH
1ndh_ AAAAAAAAAG
NIA_PICAN AAAAAAAAAF
2pia_ AAAAAAAAAM
NOS_LYMST AAAAAAAAAJ
NOS_DROME AAAAAAAAAK
1amo_A AAAAAAAAAL
1fnc_ AAAAAAAAAI
K502_ACTCH AAAAAAAAAN
FENR_SPISP AAAAAAAAAO
XYLA_PSEPU AAAAAAAAAP
ASRB_SALTY AAAAAAAAAQ
NDOR_PSEPU AAAAAAAAAR
PYRK_LISIN AAAAAAAAAS
PYRK_BACHD AAAAAAAAAT
MMOC_METCA AAAAAAAAAU
ASCD_YERPE AAAAAAAAAV
