Q9STD3 AAAAAAAAAA
Q53YH3 AAAAAAAAAB
Q9ZNY3 AAAAAAAAAC
Q3TQS0 AAAAAAAAAD
P27797 AAAAAAAAAE
Q5YER3 AAAAAAAAAF
Q8IS63 AAAAAAAAAG
Q06814 AAAAAAAAAH
Q9U6S0 AAAAAAAAAI
Q9FYV2 AAAAAAAAAJ
