EF1A_METKA AAAAAAAAAA
1kjz_A AAAAAAAAAB
IF2G_ENCCU AAAAAAAAAC
IF2P_METJA AAAAAAAAAD
IF2G_DROME AAAAAAAAAE
EF1A_TRYBB AAAAAAAAAF
