seq020 AAAAAAAAAK
seq049 AAAAAAAAAB
seq048 AAAAAAAAAC
seq045 AAAAAAAAAD
seq054 AAAAAAAAAE
seq077 AAAAAAAAAF
seq001 AAAAAAAAAG
seq064 AAAAAAAAAH
seq061 AAAAAAAAAI
seq042 AAAAAAAAAJ
seq019 AAAAAAAAAA
seq031 AAAAAAAAAL
seq068 AAAAAAAAAM
