ACP1_ENTHI AAAAAAAAAA
1yal_ AAAAAAAAAB
CATV_NPVAP AAAAAAAAAC
CYS3_OSTOS AAAAAAAAAD
1atk_ AAAAAAAAAJ
CAL2_GIALA AAAAAAAAAF
CPR1_DROME AAAAAAAAAG
1cqd_A AAAAAAAAAH
CYS1_OSTOS AAAAAAAAAI
CYSP_PEA AAAAAAAAAE
CPR4_CAEEL AAAAAAAAAK
CYSP_SCHJA AAAAAAAAAL
