C2F1_HUMAN AAAAAAAAAA
CPB6_HUMAN AAAAAAAAAB
CPC9_HUMAN AAAAAAAAAC
1f4t_A AAAAAAAAAD
C143_MYCTU AAAAAAAAAE
CPDF_CANFA AAAAAAAAAF
1e9x_A AAAAAAAAAG
CPZ5_MOUSE AAAAAAAAAH
CPCU_RABIT AAAAAAAAAI
1oxa_ AAAAAAAAAJ
CP15_CHICK AAAAAAAAAK
YJIB_BACSU AAAAAAAAAL
CP12_RABIT AAAAAAAAAM
CP51_USTMA AAAAAAAAAN
