seq038 AAAAAAAAAV
seq014 AAAAAAAAAB
seq045 AAAAAAAAAO
seq054 AAAAAAAAAC
seq073 AAAAAAAAAD
seq053 AAAAAAAAAE
seq076 AAAAAAAAAF
seq001 AAAAAAAAAG
seq064 AAAAAAAAAH
seq061 AAAAAAAAAI
seq009 AAAAAAAAAJ
seq027 AAAAAAAAAK
seq026 AAAAAAAAAL
seq069 AAAAAAAAAM
seq048 AAAAAAAAAN
seq126 AAAAAAAAAS
seq124 AAAAAAAAAP
seq106 AAAAAAAAAQ
seq107 AAAAAAAAAR
seq100 AAAAAAAAAA
seq028 AAAAAAAAAT
seq081 AAAAAAAAAU
seq082 AAAAAAAAAW
seq086 AAAAAAAAAX
