Q6GN26 AAAAAAAAAA
A0JMN3 AAAAAAAAAB
O14901 AAAAAAAAAC
Q5RIQ4 AAAAAAAAAD
Q8K1S5 AAAAAAAAAE
Q8BHJ1 AAAAAAAAAF
Q0VA55 AAAAAAAAAG
Q5ZJT5 AAAAAAAAAH
