seq059 AAAAAAAAAB
seq040 AAAAAAAAAC
seq051 AAAAAAAAAD
seq067 AAAAAAAAAE
seq013 AAAAAAAAAF
seq029 AAAAAAAAAG
seq064 AAAAAAAAAH
seq039 AAAAAAAAAA
seq007 AAAAAAAAAJ
seq068 AAAAAAAAAM
seq037 AAAAAAAAAK
seq027 AAAAAAAAAL
seq017 AAAAAAAAAI
