seq017 AAAAAAAAAR
seq020 AAAAAAAAAO
seq048 AAAAAAAAAC
seq056 AAAAAAAAAD
seq052 AAAAAAAAAE
seq041 AAAAAAAAAF
seq031 AAAAAAAAAQ
seq013 AAAAAAAAAH
seq005 AAAAAAAAAI
seq039 AAAAAAAAAB
seq014 AAAAAAAAAK
seq023 AAAAAAAAAL
seq022 AAAAAAAAAM
seq018 AAAAAAAAAG
seq037 AAAAAAAAAA
seq030 AAAAAAAAAP
seq036 AAAAAAAAAN
seq004 AAAAAAAAAJ
