LV1A_HUMAN AAAAAAAAAA
1a7n_L AAAAAAAAAB
1wit_ AAAAAAAAAI
KV2D_HUMAN AAAAAAAAAD
KV2D_MOUSE AAAAAAAAAF
LV2I_HUMAN AAAAAAAAAG
KV3F_MOUSE AAAAAAAAAH
KV03_RABIT AAAAAAAAAC
KV1X_HUMAN AAAAAAAAAJ
KV1V_HUMAN AAAAAAAAAK
KV1C_HUMAN AAAAAAAAAL
KV5A_MOUSE AAAAAAAAAE
