PROA_STRTR AAAAAAAAAA
P5CS_CAEEL AAAAAAAAAB
PROA_XANAC AAAAAAAAAC
PROA_PSEAE AAAAAAAAAD
PROA_DEIRA AAAAAAAAAE
PROA_COREF AAAAAAAAAF
PROA_CLOAB AAAAAAAAAG
PROA_MYCLE AAAAAAAAAH
