seq012 AAAAAAAAAE
seq011 AAAAAAAAAH
seq014 AAAAAAAAAK
seq010 AAAAAAAAAG
seq001 AAAAAAAAAA
seq013 AAAAAAAAAF
seq003 AAAAAAAAAD
seq002 AAAAAAAAAC
seq005 AAAAAAAAAI
seq004 AAAAAAAAAJ
seq007 AAAAAAAAAB
seq006 AAAAAAAAAL
seq009 AAAAAAAAAM
seq008 AAAAAAAAAN
