TRXB_CAEEL AAAAAAAAAA
TYTR_TRYBB AAAAAAAAAB
DLDH_CANFA AAAAAAAAAC
DLDH_BUCAI AAAAAAAAAD
DLD3_PSEPU AAAAAAAAAE
DLD1_PSEPU AAAAAAAAAF
MERA_THIFE AAAAAAAAAG
TRX1_BOVIN AAAAAAAAAJ
2tmd_A AAAAAAAAAP
DLDH_ALCEU AAAAAAAAAO
GSHC_SPIOL AAAAAAAAAK
STHA_MYCTU AAAAAAAAAM
MERA_ACICA AAAAAAAAAN
GSHR_HAEIN AAAAAAAAAL
1nhp_ AAAAAAAAAI
DLDH_BUCAP AAAAAAAAAH
1vdc_ AAAAAAAAAQ
