seq020 AAAAAAAAAM
seq048 AAAAAAAAAB
seq054 AAAAAAAAAC
seq053 AAAAAAAAAD
seq043 AAAAAAAAAE
seq051 AAAAAAAAAF
seq029 AAAAAAAAAG
seq063 AAAAAAAAAH
seq007 AAAAAAAAAI
seq022 AAAAAAAAAL
seq023 AAAAAAAAAK
seq035 AAAAAAAAAJ
seq037 AAAAAAAAAA
seq005 AAAAAAAAAN
