Y4VG_RHISN AAAAAAAAAA
CP51_HUMAN AAAAAAAAAB
1cpt_ AAAAAAAAAC
1f4t_A AAAAAAAAAD
C505_FUSOX AAAAAAAAAE
1e9x_A AAAAAAAAAF
1cl6_A AAAAAAAAAG
1lgf_A AAAAAAAAAJ
1phd_ AAAAAAAAAI
C141_MYCTU AAAAAAAAAH
CPD6_HUMAN AAAAAAAAAK
CP51_SCHPO AAAAAAAAAL
NOR2_CYLTO AAAAAAAAAS
CPXP_BRAJA AAAAAAAAAN
YJIB_BACSU AAAAAAAAAO
1pkf_A AAAAAAAAAP
CP51_SORBI AAAAAAAAAQ
CYPE_BACSU AAAAAAAAAR
1oxa_ AAAAAAAAAM
