1b8g_A AAAAAAAAAA
1dty_A AAAAAAAAAB
1d2f_A AAAAAAAAAC
1jg8_A AAAAAAAAAD
1bw0_A AAAAAAAAAE
1ax4_A AAAAAAAAAF
1ohv_A AAAAAAAAAG
1fg3_A AAAAAAAAAH
1lc5_A AAAAAAAAAI
2gsa_A AAAAAAAAAJ
1ajs_A AAAAAAAAAL
1b5o_A AAAAAAAAAN
1h1c_A AAAAAAAAAM
2dkb_ AAAAAAAAAK
