SYG_PYRAB AAAAAAAAAA
SYG_UREPA AAAAAAAAAB
1adj_A AAAAAAAAAC
SYP_STRCO AAAAAAAAAD
SYG_METKA AAAAAAAAAE
SYP_HAEIN AAAAAAAAAF
SYG_MYCPN AAAAAAAAAG
SYP_HELPJ AAAAAAAAAH
SYP_ZYMMO AAAAAAAAAI
SYG_DEIRA AAAAAAAAAJ
SYG_ARCFU AAAAAAAAAK
1qe0_A AAAAAAAAAL
SYG_YEAST AAAAAAAAAM
SYP_SYNY3 AAAAAAAAAN
