KV4A_MOUSE AAAAAAAAAA
1wit_ AAAAAAAAAB
KV3K_HUMAN AAAAAAAAAS
TVA3_HUMAN AAAAAAAAAD
LV6E_HUMAN AAAAAAAAAE
KV03_RABIT AAAAAAAAAG
KV2F_HUMAN AAAAAAAAAF
KV1V_HUMAN AAAAAAAAAL
1a64_A AAAAAAAAAI
KV2B_HUMAN AAAAAAAAAJ
KV3A_MOUSE AAAAAAAAAK
LV2F_HUMAN AAAAAAAAAH
KV3A_HUMAN AAAAAAAAAM
TVA1_MOUSE AAAAAAAAAN
KV1C_HUMAN AAAAAAAAAO
LV1I_HUMAN AAAAAAAAAP
TVA3_MOUSE AAAAAAAAAQ
KV1K_HUMAN AAAAAAAAAU
KV5G_MOUSE AAAAAAAAAC
LV1C_HUMAN AAAAAAAAAT
LV1B_HUMAN AAAAAAAAAR
