seq017 AAAAAAAAAU
seq046 AAAAAAAAAS
seq027 AAAAAAAAAO
seq047 AAAAAAAAAR
seq055 AAAAAAAAAH
seq053 AAAAAAAAAI
seq026 AAAAAAAAAP
seq042 AAAAAAAAAT
seq013 AAAAAAAAAA
seq029 AAAAAAAAAJ
seq011 AAAAAAAAAB
seq039 AAAAAAAAAC
seq044 AAAAAAAAAQ
seq023 AAAAAAAAAL
seq008 AAAAAAAAAM
seq021 AAAAAAAAAN
seq019 AAAAAAAAAD
seq030 AAAAAAAAAE
seq031 AAAAAAAAAF
seq032 AAAAAAAAAG
seq004 AAAAAAAAAK
