1n97_A AAAAAAAAAI
1cpt_ AAAAAAAAAA
1e9x_A AAAAAAAAAB
1phd_ AAAAAAAAAC
2hpd_A AAAAAAAAAE
1oxa_ AAAAAAAAAF
1dt6_A AAAAAAAAAG
1n40_A AAAAAAAAAH
1izo_A AAAAAAAAAD
