GSHR_STRTR AAAAAAAAAA
TYTR_TRYBB AAAAAAAAAB
TRB1_ARATH AAAAAAAAAC
DLDH_HALVO AAAAAAAAAD
TRXB_MYCSM AAAAAAAAAE
RURE_PSEOL AAAAAAAAAI
TRXB_CLOLI AAAAAAAAAG
TRXB_LISIN AAAAAAAAAH
TRXB_METJA AAAAAAAAAF
GSHC_SPIOL AAAAAAAAAJ
