FABG_MYCAV AAAAAAAAAA
PHBB_ALCEU AAAAAAAAAB
FABG_BUCAP AAAAAAAAAC
YWFD_BACSU AAAAAAAAAD
1dhr_ AAAAAAAAAE
SORD_KLEPN AAAAAAAAAF
YK02_MYCTU AAAAAAAAAG
1doh_A AAAAAAAAAH
NODG_RHIME AAAAAAAAAW
CMTB_PSEPU AAAAAAAAAJ
PHAB_ACISP AAAAAAAAAK
1h5q_A AAAAAAAAAL
DHS4_BOVIN AAAAAAAAAM
YD50_MYCTU AAAAAAAAAN
FABG_CHLPN AAAAAAAAAO
SOU1_CANAL AAAAAAAAAP
TRN2_DATST AAAAAAAAAQ
FIXR_BRAJA AAAAAAAAAR
SOU2_CANAL AAAAAAAAAS
FABG_BUCBP AAAAAAAAAT
ARDH_CANAL AAAAAAAAAU
1ae1_A AAAAAAAAAV
BDHA_ALCEU AAAAAAAAAI
