seq013 AAAAAAAAAA
seq011 AAAAAAAAAB
seq038 AAAAAAAAAC
seq017 AAAAAAAAAD
seq034 AAAAAAAAAE
seq018 AAAAAAAAAF
seq037 AAAAAAAAAG
seq030 AAAAAAAAAH
seq031 AAAAAAAAAI
seq054 AAAAAAAAAJ
seq050 AAAAAAAAAK
seq028 AAAAAAAAAL
seq004 AAAAAAAAAM
seq007 AAAAAAAAAN
seq006 AAAAAAAAAO
seq009 AAAAAAAAAP
seq022 AAAAAAAAAQ
seq024 AAAAAAAAAR
seq049 AAAAAAAAAS
seq043 AAAAAAAAAT
seq042 AAAAAAAAAU
seq002 AAAAAAAAAV
