seq020 AAAAAAAAAN
seq025 AAAAAAAAAO
seq059 AAAAAAAAAB
seq054 AAAAAAAAAC
seq046 AAAAAAAAAD
seq052 AAAAAAAAAE
seq043 AAAAAAAAAF
seq001 AAAAAAAAAG
seq002 AAAAAAAAAI
seq063 AAAAAAAAAJ
seq039 AAAAAAAAAK
seq006 AAAAAAAAAL
seq018 AAAAAAAAAM
seq037 AAAAAAAAAA
seq032 AAAAAAAAAH
seq017 AAAAAAAAAP
