FKB1_DROME AAAAAAAAAA
FKBP_CORGL AAAAAAAAAE
FKB2_ARATH AAAAAAAAAB
1hxv_A AAAAAAAAAI
FKBA_AERHY AAAAAAAAAC
TIG_RHILO AAAAAAAAAF
FK22_ARATH AAAAAAAAAH
FKBH_SCHPO AAAAAAAAAJ
FKB3_ARATH AAAAAAAAAD
FKBY_HAEIN AAAAAAAAAG
FKB2_HUMAN AAAAAAAAAK
