AMYA_DROMA AAAAAAAAAA
GLGB_NITEU AAAAAAAAAM
AMY_TENMO AAAAAAAAAB
GLGB_SYNP7 AAAAAAAAAC
GLGB_BACAA AAAAAAAAAD
GLGB_STRMU AAAAAAAAAE
CDAS_THEET AAAAAAAAAF
CDAS_BACSH AAAAAAAAAT
GLGB_STRPN AAAAAAAAAH
GLGB_COREF AAAAAAAAAI
MALZ_ECOLI AAAAAAAAAJ
1smd_ AAAAAAAAAK
GLGB_PSESM AAAAAAAAAL
GLGB_RALSO AAAAAAAAAG
AMY_STRHY AAAAAAAAAN
GLB1_XANAC AAAAAAAAAO
AMY_BACCI AAAAAAAAAP
CDG1_PAEMA AAAAAAAAAQ
CDGT_KLEOX AAAAAAAAAS
GLGB_CHLCV AAAAAAAAAR
