Q6DH18 AAAAAAAAAA
P34693 AAAAAAAAAH
P21579 AAAAAAAAAC
Q25393 AAAAAAAAAD
Q3LRV5 AAAAAAAAAE
Q9BMF3 AAAAAAAAAF
O00445 AAAAAAAAAG
Q9U8R6 AAAAAAAAAB
Q66KE5 AAAAAAAAAI
Q869G5 AAAAAAAAAJ
