PNO_CRYPV AAAAAAAAAF
RNFB_VIBPA AAAAAAAAAG
RNFC_VIBCH AAAAAAAAAH
Y514_METJA AAAAAAAAAI
FPRB_MYCTU AAAAAAAAAA
1q16_B AAAAAAAAAB
1b0p_A AAAAAAAAAC
PHFL_DESVO AAAAAAAAAD
FRHG_METVO AAAAAAAAAE
