SYT1_AERPE AAAAAAAAAN
SYT_BORBU AAAAAAAAAB
SYT_BUCBP AAAAAAAAAC
SYTC_YEAST AAAAAAAAAD
1evk_A AAAAAAAAAA
SYT_CAUCR AAAAAAAAAF
SYT_MYCPN AAAAAAAAAG
SYT_AQUAE AAAAAAAAAH
SYT_MYCPU AAAAAAAAAI
1nj8_A AAAAAAAAAJ
SYT_SYNY3 AAAAAAAAAK
SYT_THETN AAAAAAAAAL
SYT_DEIRA AAAAAAAAAM
SYT_CHLMU AAAAAAAAAE
SYT_BRUME AAAAAAAAAO
SYT_ARATH AAAAAAAAAP
SYT_SULSO AAAAAAAAAQ
SYT_TREPA AAAAAAAAAR
