seq049 AAAAAAAAAA
seq058 AAAAAAAAAB
seq057 AAAAAAAAAC
seq047 AAAAAAAAAD
seq041 AAAAAAAAAE
seq026 AAAAAAAAAN
seq051 AAAAAAAAAF
seq013 AAAAAAAAAG
seq028 AAAAAAAAAH
seq004 AAAAAAAAAJ
seq007 AAAAAAAAAK
seq022 AAAAAAAAAM
seq035 AAAAAAAAAL
seq031 AAAAAAAAAI
seq069 AAAAAAAAAO
