seq078 AAAAAAAAAA
seq001 AAAAAAAAAE
seq122 AAAAAAAAAC
seq105 AAAAAAAAAD
seq089 AAAAAAAAAB
seq115 AAAAAAAAAF
seq080 AAAAAAAAAG
seq019 AAAAAAAAAH
seq085 AAAAAAAAAI
seq032 AAAAAAAAAJ
seq068 AAAAAAAAAK
