TYSY_CLOAB AAAAAAAAAA
TYSY_HAEDU AAAAAAAAAP
TYSY_STAAM AAAAAAAAAC
DRTS_PARTE AAAAAAAAAD
TYSY_CAUCR AAAAAAAAAG
TYSY_SHEON AAAAAAAAAF
TYSY_NEIGO AAAAAAAAAE
TYSY_AGRT5 AAAAAAAAAH
TYSY_KSHV AAAAAAAAAI
TYSY_YEAST AAAAAAAAAJ
TYSY_AGABI AAAAAAAAAK
DRTS_CRIFA AAAAAAAAAL
TYSY_HSVAT AAAAAAAAAO
TYSY_ASCSU AAAAAAAAAN
TYSY_BACAA AAAAAAAAAB
TYSY_MYCPN AAAAAAAAAM
DRTS_TOXGO AAAAAAAAAQ
