NORW_ECO57 AAAAAAAAAA
TRXB_RICCN AAAAAAAAAB
NIR_EMENI AAAAAAAAAC
YDGE_SCHPO AAAAAAAAAD
THCD_RHOER AAAAAAAAAE
BPHG_BURCE AAAAAAAAAF
