ABL_DROME AAAAAAAAAA
CSW_DROME AAAAAAAAAB
TXK_HUMAN AAAAAAAAAC
HT16_HYDAT AAAAAAAAAD
SRMS_MOUSE AAAAAAAAAI
SLA2_MOUSE AAAAAAAAAF
STK_HYDAT AAAAAAAAAG
NCK2_HUMAN AAAAAAAAAH
SR64_DROME AAAAAAAAAE
SOC4_HUMAN AAAAAAAAAJ
