seq058 AAAAAAAAAD
seq100 AAAAAAAAAE
seq101 AAAAAAAAAF
seq060 AAAAAAAAAN
seq040 AAAAAAAAAH
seq106 AAAAAAAAAI
seq051 AAAAAAAAAJ
seq032 AAAAAAAAAR
seq114 AAAAAAAAAK
seq005 AAAAAAAAAL
seq120 AAAAAAAAAM
seq077 AAAAAAAAAP
seq015 AAAAAAAAAG
seq080 AAAAAAAAAO
seq082 AAAAAAAAAC
seq027 AAAAAAAAAQ
seq085 AAAAAAAAAS
seq094 AAAAAAAAAA
seq024 AAAAAAAAAB
