SSRP_CAEEL AAAAAAAAAA
HMGH_STRPU AAAAAAAAAC
HMGL_TRYBR AAAAAAAAAD
HMGL_VICFA AAAAAAAAAE
SSRP_CHICK AAAAAAAAAF
1aab_ AAAAAAAAAG
HMGL_SOYBN AAAAAAAAAH
SP10_GORGO AAAAAAAAAI
HMG2_DROME AAAAAAAAAJ
2lef_A AAAAAAAAAL
HG12_CAEEL AAAAAAAAAP
SSRP_ARATH AAAAAAAAAK
1e7j_A AAAAAAAAAM
SSTP_CATRO AAAAAAAAAN
HMGA_CHITE AAAAAAAAAO
HMGC_TETTH AAAAAAAAAB
