seq207 AAAAAAAAAB
seq056 AAAAAAAAAD
seq071 AAAAAAAAAE
seq047 AAAAAAAAAF
seq240 AAAAAAAAAT
seq115 AAAAAAAAAK
seq076 AAAAAAAAAH
seq132 AAAAAAAAAI
seq009 AAAAAAAAAN
seq029 AAAAAAAAAG
seq174 AAAAAAAAAL
seq111 AAAAAAAAAM
seq191 AAAAAAAAAS
seq081 AAAAAAAAAJ
seq145 AAAAAAAAAO
seq195 AAAAAAAAAP
seq244 AAAAAAAAAQ
seq156 AAAAAAAAAR
seq032 AAAAAAAAAC
seq024 AAAAAAAAAA
