q59050 AAAAAAAAAA
o06724 AAAAAAAAAM
o28058 AAAAAAAAAC
o07877 AAAAAAAAAF
Q9UYW0 AAAAAAAAAE
p73637 AAAAAAAAAD
q9x4x5 AAAAAAAAAG
o07875 AAAAAAAAAH
Q94272 AAAAAAAAAI
Q46978_1 AAAAAAAAAJ
Q46978_2 AAAAAAAAAK
O86346 AAAAAAAAAL
O30145 AAAAAAAAAB
o86527 AAAAAAAAAN
faaa_mouse AAAAAAAAAO
