seq011 AAAAAAAAAA
seq016 AAAAAAAAAB
seq017 AAAAAAAAAC
seq014 AAAAAAAAAD
seq034 AAAAAAAAAE
seq036 AAAAAAAAAF
seq037 AAAAAAAAAG
seq030 AAAAAAAAAH
seq018 AAAAAAAAAI
seq032 AAAAAAAAAJ
seq001 AAAAAAAAAK
seq003 AAAAAAAAAV
seq004 AAAAAAAAAM
seq007 AAAAAAAAAN
seq006 AAAAAAAAAO
seq009 AAAAAAAAAP
seq021 AAAAAAAAAQ
seq026 AAAAAAAAAR
seq025 AAAAAAAAAS
seq024 AAAAAAAAAT
seq041 AAAAAAAAAU
seq029 AAAAAAAAAL
seq039 AAAAAAAAAW
