SYFA_METTH AAAAAAAAAA
1asz_B AAAAAAAAAB
1b70_A AAAAAAAAAC
1adj_A AAAAAAAAAD
SYFA_MYCBO AAAAAAAAAE
SYFA_SYNEL AAAAAAAAAF
SYFA_METJA AAAAAAAAAG
SYFA_TREPA AAAAAAAAAH
SYFA_THEAC AAAAAAAAAI
SYFA_THETN AAAAAAAAAJ
SYFA_HALN1 AAAAAAAAAK
SYFA_ARATH AAAAAAAAAL
SYFA_SULTO AAAAAAAAAM
