GSA_PSEAE AAAAAAAAAA
GSA_BACHD AAAAAAAAAB
1jg8_A AAAAAAAAAC
1ohv_A AAAAAAAAAD
GSA_SHEON AAAAAAAAAE
GSA_SYNY3 AAAAAAAAAF
GSA_ECO57 AAAAAAAAAG
GSA1_ARATH AAAAAAAAAH
GSA_AQUAE AAAAAAAAAI
1b5o_A AAAAAAAAAJ
