seq111 AAAAAAAAAN
seq058 AAAAAAAAAC
seq101 AAAAAAAAAD
seq054 AAAAAAAAAE
seq125 AAAAAAAAAF
seq130 AAAAAAAAAG
seq043 AAAAAAAAAM
seq107 AAAAAAAAAH
seq067 AAAAAAAAAI
seq029 AAAAAAAAAJ
seq011 AAAAAAAAAK
seq063 AAAAAAAAAL
seq119 AAAAAAAAAR
seq014 AAAAAAAAAB
seq127 AAAAAAAAAO
seq082 AAAAAAAAAP
seq121 AAAAAAAAAQ
seq025 AAAAAAAAAA
