1fov_A AAAAAAAAAA
THH1_TOBAC AAAAAAAAAB
THIO_EMENI AAAAAAAAAC
DSBE_HAEIN AAAAAAAAAN
SH3N_HUMAN AAAAAAAAAE
SH3L_HUMAN AAAAAAAAAF
TYPX_TRYBB AAAAAAAAAG
TXN4_HUMAN AAAAAAAAAH
THIO_CHLCV AAAAAAAAAI
1grx_ AAAAAAAAAJ
THIO_ICTPU AAAAAAAAAL
THM2_ARATH AAAAAAAAAM
THM4_ARATH AAAAAAAAAK
THIO_MYCGA AAAAAAAAAP
TRX2_YEAST AAAAAAAAAO
THI3_DICDI AAAAAAAAAD
DSBE_PSEFL AAAAAAAAAQ
NRFX_HAEIN AAAAAAAAAR
DSBE_ECOLI AAAAAAAAAS
THIO_COPCM AAAAAAAAAT
THIM_ORYSA AAAAAAAAAU
