P11346 AAAAAAAAAA
Q5K4U1 AAAAAAAAAE
Q6A1B3 AAAAAAAAAC
Q4H2W3 AAAAAAAAAD
P04049 AAAAAAAAAB
