seq100 AAAAAAAAAA
seq044 AAAAAAAAAB
seq107 AAAAAAAAAC
seq011 AAAAAAAAAD
seq016 AAAAAAAAAE
seq014 AAAAAAAAAF
seq134 AAAAAAAAAG
seq092 AAAAAAAAAH
seq021 AAAAAAAAAI
seq127 AAAAAAAAAJ
seq032 AAAAAAAAAK
seq068 AAAAAAAAAL
