seq048 AAAAAAAAAA
seq057 AAAAAAAAAB
seq051 AAAAAAAAAC
seq029 AAAAAAAAAD
seq002 AAAAAAAAAE
seq004 AAAAAAAAAF
seq014 AAAAAAAAAG
seq015 AAAAAAAAAH
seq032 AAAAAAAAAI
