seq013 AAAAAAAAAA
seq010 AAAAAAAAAB
seq038 AAAAAAAAAC
seq017 AAAAAAAAAD
seq034 AAAAAAAAAE
seq036 AAAAAAAAAF
seq019 AAAAAAAAAG
seq031 AAAAAAAAAH
seq032 AAAAAAAAAI
seq001 AAAAAAAAAJ
seq029 AAAAAAAAAK
seq002 AAAAAAAAAL
seq005 AAAAAAAAAM
seq004 AAAAAAAAAN
seq023 AAAAAAAAAO
seq022 AAAAAAAAAP
seq027 AAAAAAAAAQ
seq024 AAAAAAAAAR
seq049 AAAAAAAAAS
seq048 AAAAAAAAAT
seq045 AAAAAAAAAU
seq044 AAAAAAAAAV
seq040 AAAAAAAAAW
seq043 AAAAAAAAAX
seq016 AAAAAAAAAY
