P46703 AAAAAAAAAA
Q9fs88 AAAAAAAAAB
Q9fs87 AAAAAAAAAC
Q9d7b6 AAAAAAAAAD
Q8jzn5 AAAAAAAAAE
Q10535 AAAAAAAAAF
P76200 AAAAAAAAAG
P52042 AAAAAAAAAH
P34355 AAAAAAAAAI
Q9z1n0 AAAAAAAAAM
P41367 AAAAAAAAAK
P48818 AAAAAAAAAL
P16219 AAAAAAAAAJ
P13711 AAAAAAAAAN
P08503 AAAAAAAAAO
Q8hxy7 AAAAAAAAAP
P06598 AAAAAAAAAQ
Q22347 AAAAAAAAAR
Q9swg0 AAAAAAAAAS
P45857 AAAAAAAAAT
P15650 AAAAAAAAAU
Q9dbl1 AAAAAAAAAV
1rx0_A AAAAAAAAAW
P45954 AAAAAAAAAX
P26440 AAAAAAAAAY
