seq044 AAAAAAAAAA
seq072 AAAAAAAAAB
seq052 AAAAAAAAAC
seq040 AAAAAAAAAD
seq050 AAAAAAAAAE
seq074 AAAAAAAAAF
seq001 AAAAAAAAAG
seq065 AAAAAAAAAH
seq028 AAAAAAAAAI
seq006 AAAAAAAAAJ
seq035 AAAAAAAAAK
seq018 AAAAAAAAAL
seq019 AAAAAAAAAM
seq029 AAAAAAAAAN
seq024 AAAAAAAAAO
