O14901_1 AAAAAAAAAA
SWI5_YEAST_3 AAAAAAAAAB
SWI5_YEAST_1 AAAAAAAAAC
YADD_SCHPO_1 AAAAAAAAAD
ACE2_YEAST_3 AAAAAAAAAE
ACE2_YEAST_1 AAAAAAAAAF
