seq013 AAAAAAAAAA
seq010 AAAAAAAAAB
seq011 AAAAAAAAAC
seq016 AAAAAAAAAD
seq036 AAAAAAAAAE
seq037 AAAAAAAAAI
seq031 AAAAAAAAAG
seq033 AAAAAAAAAH
seq019 AAAAAAAAAF
seq070 AAAAAAAAAV
seq053 AAAAAAAAAK
seq050 AAAAAAAAAL
seq003 AAAAAAAAAP
seq005 AAAAAAAAAN
seq060 AAAAAAAAAO
seq021 AAAAAAAAAQ
seq068 AAAAAAAAAR
seq041 AAAAAAAAAS
seq040 AAAAAAAAAT
seq043 AAAAAAAAAU
seq056 AAAAAAAAAJ
seq029 AAAAAAAAAM
