Q9fya6 AAAAAAAAAA
Q99w55 AAAAAAAAAB
Q9y885 AAAAAAAAAC
1a3g_A AAAAAAAAAD
P54691 AAAAAAAAAE
P54689 AAAAAAAAAF
1ekf_A AAAAAAAAAG
