SYTC_YEAST AAAAAAAAAA
SYT_THEMA AAAAAAAAAB
1evk_A AAAAAAAAAC
SYT_MYCPN AAAAAAAAAD
SYT_WIGBR AAAAAAAAAE
SYT_DEIRA AAAAAAAAAF
SYT_FUSNN AAAAAAAAAG
SYT_CLOPE AAAAAAAAAH
SYT_THETH AAAAAAAAAI
