seq001 AAAAAAAAAA
seq003 AAAAAAAAAB
seq002 AAAAAAAAAC
seq005 AAAAAAAAAD
seq004 AAAAAAAAAE
seq007 AAAAAAAAAF
seq006 AAAAAAAAAG
