PTPZ_HUMAN AAAAAAAAAA
CAH6_MOUSE AAAAAAAAAB
CAH3_CAEEL AAAAAAAAAC
CAHZ_BRARE AAAAAAAAAD
CAH6_HUMAN AAAAAAAAAE
CAH_DUNSA AAAAAAAAAF
CAH2_CHICK AAAAAAAAAG
CAH9_HUMAN AAAAAAAAAH
CAH6_BOVIN AAAAAAAAAI
CAHB_HUMAN AAAAAAAAAJ
CAH2_CAEEL AAAAAAAAAK
CAH9_MOUSE AAAAAAAAAL
CAH5_MOUSE AAAAAAAAAM
CAHF_MOUSE AAAAAAAAAN
CAH5_CAEEL AAAAAAAAAO
CAH2_BOVIN AAAAAAAAAP
CAH8_HUMAN AAAAAAAAAQ
1znc_A AAAAAAAAAR
1jcz_A AAAAAAAAAS
CAH2_MOUSE AAAAAAAAAT
CAH4_RABIT AAAAAAAAAU
CAHE_HUMAN AAAAAAAAAV
