1jdc_ AAAAAAAAAF
APU_THEET AAAAAAAAAB
CDAS_BACSH AAAAAAAAAC
1bvz_A AAAAAAAAAD
CDGT_KLEOX AAAAAAAAAE
CDGT_BACST AAAAAAAAAA
AMY3_DICTH AAAAAAAAAG
MAL2_DROME AAAAAAAAAH
AMY2_SCHPO AAAAAAAAAI
AMY_BACCI AAAAAAAAAJ
AMY4_SCHPO AAAAAAAAAK
