seq059 AAAAAAAAAA
seq046 AAAAAAAAAB
seq041 AAAAAAAAAC
seq043 AAAAAAAAAD
seq005 AAAAAAAAAE
seq017 AAAAAAAAAF
seq018 AAAAAAAAAG
seq024 AAAAAAAAAK
seq036 AAAAAAAAAI
seq069 AAAAAAAAAJ
seq068 AAAAAAAAAH
