seq078 AAAAAAAAAA
seq049 AAAAAAAAAB
seq014 AAAAAAAAAL
seq059 AAAAAAAAAD
seq044 AAAAAAAAAE
seq073 AAAAAAAAAF
seq043 AAAAAAAAAG
seq051 AAAAAAAAAH
seq033 AAAAAAAAAR
seq010 AAAAAAAAAI
seq064 AAAAAAAAAJ
seq016 AAAAAAAAAK
seq007 AAAAAAAAAC
seq015 AAAAAAAAAM
seq020 AAAAAAAAAO
seq030 AAAAAAAAAP
seq031 AAAAAAAAAQ
seq068 AAAAAAAAAN
