seq022 AAAAAAAAAA
seq029 AAAAAAAAAB
seq019 AAAAAAAAAC
seq003 AAAAAAAAAD
seq025 AAAAAAAAAE
