SYFA_THEVO AAAAAAAAAA
1b70_A AAAAAAAAAB
SYFA_BACTN AAAAAAAAAC
SYFA_AERPE AAAAAAAAAD
SYFA_PYRAE AAAAAAAAAE
SYFA_PYRAB AAAAAAAAAF
SYFA_SULSO AAAAAAAAAG
SYFA_METJA AAAAAAAAAH
SYFA_MYCGA AAAAAAAAAI
SYFA_METAC AAAAAAAAAJ
SYFA_HALN1 AAAAAAAAAK
SYFA_ARATH AAAAAAAAAL
