seq078 AAAAAAAAAA
seq035 AAAAAAAAAO
seq044 AAAAAAAAAC
seq055 AAAAAAAAAD
seq104 AAAAAAAAAE
seq075 AAAAAAAAAF
seq050 AAAAAAAAAG
seq074 AAAAAAAAAH
seq034 AAAAAAAAAN
seq099 AAAAAAAAAK
seq004 AAAAAAAAAL
seq071 AAAAAAAAAJ
seq023 AAAAAAAAAI
seq022 AAAAAAAAAB
seq020 AAAAAAAAAP
seq015 AAAAAAAAAM
seq025 AAAAAAAAAQ
seq085 AAAAAAAAAR
